mr	output
"name[Alimentum], area[city centre], familyFriendly[no]"	Alimentum is located in the city centre. It is not family-friendly.
"name[Alimentum], area[city centre], familyFriendly[no], near[Burger King]"	Alimentum is a non family-friendly restaurant near Burger King in the city centre.
"name[Alimentum], area[city centre], familyFriendly[yes]"	Alimentum is a family-friendly restaurant in the city centre.
"name[Alimentum], area[city centre], familyFriendly[yes], near[Burger King]"	Alimentum is a family-friendly restaurant in the city centre near Burger King.
"name[Alimentum], area[riverside], familyFriendly[no]"	Alimentum is located in the city centre. It is not family-friendly.
"name[Alimentum], area[riverside], familyFriendly[no], near[Burger King]"	Alimentum is near Burger King in the riverside area. It is not family-friendly.
"name[Alimentum], area[riverside], familyFriendly[yes]"	In the riverside area there is a family friendly place called Alimentum.
"name[Alimentum], area[riverside], familyFriendly[yes], near[Burger King]"	Alimentum is a family friendly restaurant in the riverside area near Burger King.
"name[Aromi], eatType[coffee shop], food[Chinese], customer rating[1 out of 5], area[riverside], familyFriendly[yes]"	Aromi is a kid friendly coffee shop serving chinese food in the riverside area with a customer rating of 1 out of 5.
"name[Aromi], eatType[coffee shop], food[Chinese], customer rating[3 out of 5], area[riverside], familyFriendly[yes]"	Aromi is a kid friendly coffee shop serving chinese food in the riverside area with a customer rating of 3 out of 5.
"name[Aromi], eatType[coffee shop], food[Chinese], customer rating[5 out of 5], area[city centre], familyFriendly[no]"	Aromi is a chinese coffee shop located in the city centre. It has a customer rating of 5 out of 5 and is not family friendly.
"name[Aromi], eatType[coffee shop], food[Chinese], customer rating[5 out of 5], area[city centre], familyFriendly[yes]"	Aromi is a family friendly chinese coffee shop located in the city centre with a 5 out of 5 customer rating.
"name[Aromi], eatType[coffee shop], food[Chinese], customer rating[5 out of 5], area[riverside], familyFriendly[no]"	Aromi is a chinese coffee shop located in the riverside area. It has a customer rating of 5 out of 5 and is not family friendly.
"name[Aromi], eatType[coffee shop], food[Chinese], customer rating[5 out of 5], area[riverside], familyFriendly[yes]"	Aromi is a 5 out of 5 family friendly chinese coffee shop in the riverside area.
"name[Aromi], eatType[coffee shop], food[Chinese], customer rating[average], area[city centre], familyFriendly[no]"	Aromi is a chinese coffee shop located in the city centre. It has an average customer rating and is not family friendly.
"name[Aromi], eatType[coffee shop], food[Chinese], customer rating[average], area[city centre], familyFriendly[yes]"	Aromi is a chinese coffee shop located in the city centre. It has an average customer rating and is family friendly.
"name[Aromi], eatType[coffee shop], food[Chinese], customer rating[average], area[riverside], familyFriendly[no]"	Aromi is a chinese coffee shop in the riverside area. It has an average customer rating and is not family friendly.
"name[Aromi], eatType[coffee shop], food[Chinese], customer rating[average], area[riverside], familyFriendly[yes]"	Aromi is a family friendly chinese coffee shop in the riverside area. It has an average customer rating.
"name[Aromi], eatType[coffee shop], food[Chinese], customer rating[high], area[riverside], familyFriendly[yes]"	Aromi is a highly rated, kid friendly coffee shop that serves chinese food in the riverside area.
"name[Aromi], eatType[coffee shop], food[Chinese], customer rating[low], area[city centre], familyFriendly[no]"	Aromi is a coffee shop providing chinese food it is located in the city centre. Its customer rating is low.
"name[Aromi], eatType[coffee shop], food[Chinese], customer rating[low], area[city centre], familyFriendly[yes]"	Aromi is a coffee shop that provides chinese food it is located in the city centre. Its customer rating is low.
"name[Aromi], eatType[coffee shop], food[Chinese], customer rating[low], area[riverside], familyFriendly[no]"	Aromi is a coffee shop providing chinese food it is located in the riverside. Its customer rating is low.
"name[Aromi], eatType[coffee shop], food[Chinese], customer rating[low], area[riverside], familyFriendly[yes]"	Aromi is a family friendly coffee shop that provides chinese food it is located in the riverside. Its customer rating is low.
"name[Aromi], eatType[coffee shop], food[English], customer rating[1 out of 5], area[riverside], familyFriendly[yes]"	Aromi is a kid friendly coffee shop serving english food in the riverside area with a customer rating of 1 out of 5.
"name[Aromi], eatType[coffee shop], food[English], customer rating[3 out of 5], area[riverside], familyFriendly[yes]"	Aromi is a kid friendly coffee shop serving english food in the riverside area with a customer rating of 3 out of 5.
"name[Aromi], eatType[coffee shop], food[English], customer rating[5 out of 5], area[city centre], familyFriendly[no]"	Aromi is a coffee shop serving english food in the city centre. It has a customer rating of 5 out of 5 and is not family-friendly.
"name[Aromi], eatType[coffee shop], food[English], customer rating[5 out of 5], area[city centre], familyFriendly[yes]"	Aromi is a family-friendly coffee shop serving english food in the city centre with a customer rating of 5 out of 5.
"name[Aromi], eatType[coffee shop], food[English], customer rating[5 out of 5], area[riverside], familyFriendly[no]"	Aromi is a coffee shop providing english food in the riverside area. It has a customer rating of 5 out of 5 and is not family-friendly.
"name[Aromi], eatType[coffee shop], food[English], customer rating[5 out of 5], area[riverside], familyFriendly[yes]"	Aromi is a family friendly coffee shop serving english food in the riverside area with a customer rating of 5 out of 5.
"name[Aromi], eatType[coffee shop], food[English], customer rating[average], area[city centre], familyFriendly[no]"	Aromi is a coffee shop serving english food in the city centre. It has an average customer rating and is not family-friendly.
"name[Aromi], eatType[coffee shop], food[English], customer rating[average], area[city centre], familyFriendly[yes]"	Aromi is a family-friendly coffee shop serving english food in the city centre with an average customer rating.
"name[Aromi], eatType[coffee shop], food[English], customer rating[average], area[riverside], familyFriendly[no]"	Aromi is a coffee shop serving english food in the riverside area. It has an average customer rating and is not family-friendly.
"name[Aromi], eatType[coffee shop], food[English], customer rating[average], area[riverside], familyFriendly[yes]"	Aromi is a family friendly coffee shop serving english food in the riverside area. It has an average customer rating.
"name[Aromi], eatType[coffee shop], food[English], customer rating[high], area[riverside], familyFriendly[yes]"	Aromi is a child friendly coffee shop serving english food in the riverside area with a high customer rating.
"name[Aromi], eatType[coffee shop], food[English], customer rating[low], area[city centre], familyFriendly[no]"	Aromi is a coffee shop serving english food in the city centre. It has a low customer rating and is not family-friendly.
"name[Aromi], eatType[coffee shop], food[English], customer rating[low], area[city centre], familyFriendly[yes]"	Aromi is a family-friendly coffee shop serving english food in the city centre with a low customer rating.
"name[Aromi], eatType[coffee shop], food[English], customer rating[low], area[riverside], familyFriendly[no]"	Aromi is an english coffee shop in the riverside area. It has a low customer rating and is not family-friendly.
"name[Aromi], eatType[coffee shop], food[English], customer rating[low], area[riverside], familyFriendly[yes]"	Aromi is a family friendly coffee shop serving english food in the riverside area. It has a low customer rating.
"name[Bibimbap House], area[city centre], near[Café Sicilia]"	Bibimbap House is a restaurant near Café Sicilia in the city centre.
"name[Bibimbap House], area[riverside], near[Café Sicilia]"	Bibimbap House is located by the riverside near Café Sicilia.
"name[Browns Cambridge], eatType[coffee shop], food[Chinese], customer rating[1 out of 5], area[riverside], familyFriendly[yes], near[Crowne Plaza Hotel]"	Browns Cambridge is a coffee shop providing chinese food it is located in the riverside. It is near Crowne Plaza Hotel. Its customer rating is 1 out of 5.
"name[Browns Cambridge], eatType[coffee shop], food[Chinese], customer rating[3 out of 5], area[riverside], familyFriendly[yes], near[Crowne Plaza Hotel]"	Browns Cambridge is a coffee shop serving chinese food in the riverside area near Crowne Plaza Hotel. It has a customer rating of 3 out of 5 and is kid friendly.
"name[Browns Cambridge], eatType[coffee shop], food[Chinese], customer rating[5 out of 5], area[city centre], familyFriendly[no], near[Crowne Plaza Hotel]"	Browns Cambridge is a chinese coffee shop located in the city centre near Crowne Plaza Hotel. It has a customer rating of 5 out of 5 and is not family friendly.
"name[Browns Cambridge], eatType[coffee shop], food[Chinese], customer rating[5 out of 5], area[city centre], familyFriendly[yes], near[Crowne Plaza Hotel]"	Browns Cambridge is a family friendly chinese coffee shop located in the city centre near Crowne Plaza Hotel. It has a customer rating of 5 out of 5.
"name[Browns Cambridge], eatType[coffee shop], food[Chinese], customer rating[5 out of 5], area[riverside], familyFriendly[no], near[Crowne Plaza Hotel]"	Browns Cambridge is a chinese coffee shop in the riverside area near Crowne Plaza Hotel. It has a customer rating of 5 out of 5 and is not family friendly.
"name[Browns Cambridge], eatType[coffee shop], food[Chinese], customer rating[5 out of 5], area[riverside], familyFriendly[yes], near[Crowne Plaza Hotel]"	Browns Cambridge is a coffee shop providing chinese food it is located in the riverside. It is near Crowne Plaza Hotel. Its customer rating is 5 out of 5.
"name[Browns Cambridge], eatType[coffee shop], food[Chinese], customer rating[average], area[city centre], familyFriendly[no], near[Crowne Plaza Hotel]"	Browns Cambridge is a chinese coffee shop located in the city centre near Crowne Plaza Hotel. It has an average customer rating and is not family friendly.
"name[Browns Cambridge], eatType[coffee shop], food[Chinese], customer rating[average], area[city centre], familyFriendly[yes], near[Crowne Plaza Hotel]"	Browns Cambridge is a family friendly chinese coffee shop located in the city centre near Crowne Plaza Hotel. It has an average customer rating.
"name[Browns Cambridge], eatType[coffee shop], food[Chinese], customer rating[average], area[riverside], familyFriendly[no], near[Crowne Plaza Hotel]"	Browns Cambridge is a chinese coffee shop in the riverside area near Crowne Plaza Hotel. It has an average customer rating and is not family friendly.
"name[Browns Cambridge], eatType[coffee shop], food[Chinese], customer rating[average], area[riverside], familyFriendly[yes], near[Crowne Plaza Hotel]"	Browns Cambridge is a family friendly chinese coffee shop located in the riverside area near Crowne Plaza Hotel. It has an average customer rating.
"name[Browns Cambridge], eatType[coffee shop], food[Chinese], customer rating[high], area[riverside], familyFriendly[yes], near[Crowne Plaza Hotel]"	Browns Cambridge is a coffee shop providing chinese food it is located in the riverside. It is near Crowne Plaza Hotel and its customer rating is high.
"name[Browns Cambridge], eatType[coffee shop], food[Chinese], customer rating[low], area[city centre], familyFriendly[no], near[Crowne Plaza Hotel]"	Browns Cambridge is a chinese coffee shop located in the city centre near Crowne Plaza Hotel. It has a low customer rating and is not family friendly.
"name[Browns Cambridge], eatType[coffee shop], food[Chinese], customer rating[low], area[city centre], familyFriendly[yes], near[Crowne Plaza Hotel]"	Browns Cambridge is a family friendly chinese coffee shop located near Crowne Plaza Hotel in the city centre.
"name[Browns Cambridge], eatType[coffee shop], food[Chinese], customer rating[low], area[riverside], familyFriendly[no], near[Crowne Plaza Hotel]"	Browns Cambridge is a chinese coffee shop in the riverside area near Crowne Plaza Hotel. It has a low customer rating and is not family friendly.
"name[Browns Cambridge], eatType[coffee shop], food[Chinese], customer rating[low], area[riverside], familyFriendly[yes], near[Crowne Plaza Hotel]"	Browns Cambridge is a family friendly coffee shop that serves chinese food. It has a low customer rating and is located in the riverside area near Crowne Plaza Hotel.
"name[Browns Cambridge], eatType[coffee shop], food[English], customer rating[1 out of 5], area[riverside], familyFriendly[yes], near[Crowne Plaza Hotel]"	Browns Cambridge is a coffee shop providing english food. It is located in the riverside area near Crowne Plaza Hotel. It has a customer rating of 1 out of 5 and is kid friendly.
"name[Browns Cambridge], eatType[coffee shop], food[English], customer rating[3 out of 5], area[riverside], familyFriendly[yes], near[Crowne Plaza Hotel]"	Browns Cambridge is a kid friendly coffee shop serving english food near Crowne Plaza Hotel in the riverside area. It has a customer rating of 3 out of 5.
"name[Browns Cambridge], eatType[coffee shop], food[English], customer rating[5 out of 5], area[city centre], familyFriendly[no], near[Crowne Plaza Hotel]"	Browns Cambridge is a coffee shop serving english food near Crowne Plaza Hotel in the city centre. It has a customer rating of 5 out of 5 and is not family-friendly.
"name[Browns Cambridge], eatType[coffee shop], food[English], customer rating[5 out of 5], area[city centre], familyFriendly[yes], near[Crowne Plaza Hotel]"	Browns Cambridge is a family-friendly coffee shop serving english food with a customer rating of 5 out of 5. It is located in the city centre near Crowne Plaza Hotel.
"name[Browns Cambridge], eatType[coffee shop], food[English], customer rating[5 out of 5], area[riverside], familyFriendly[no], near[Crowne Plaza Hotel]"	Browns Cambridge is a coffee shop serving english food near Crowne Plaza Hotel in the riverside area. It has a customer rating of 5 out of 5 and is not family-friendly.
"name[Browns Cambridge], eatType[coffee shop], food[English], customer rating[5 out of 5], area[riverside], familyFriendly[yes], near[Crowne Plaza Hotel]"	Browns Cambridge is a family friendly coffee shop serving english food near Crowne Plaza Hotel in the riverside area. It has a customer rating of 5 out of 5.
"name[Browns Cambridge], eatType[coffee shop], food[English], customer rating[average], area[city centre], familyFriendly[no], near[Crowne Plaza Hotel]"	Browns Cambridge is a coffee shop serving english food near Crowne Plaza Hotel in the city centre. It has an average customer rating and is not family-friendly.
"name[Browns Cambridge], eatType[coffee shop], food[English], customer rating[average], area[city centre], familyFriendly[yes], near[Crowne Plaza Hotel]"	Browns Cambridge is a family-friendly coffee shop serving english food near Crowne Plaza Hotel in the city centre. It has an average customer rating.
"name[Browns Cambridge], eatType[coffee shop], food[English], customer rating[average], area[riverside], familyFriendly[no], near[Crowne Plaza Hotel]"	Browns Cambridge is a coffee shop serving english food near Crowne Plaza Hotel in the riverside area. It has an average customer rating and is not family-friendly.
"name[Browns Cambridge], eatType[coffee shop], food[English], customer rating[average], area[riverside], familyFriendly[yes], near[Crowne Plaza Hotel]"	Browns Cambridge is a family friendly coffee shop serving english food near Crowne Plaza Hotel in the riverside area. It has an average customer rating.
"name[Browns Cambridge], eatType[coffee shop], food[English], customer rating[high], area[riverside], familyFriendly[yes], near[Crowne Plaza Hotel]"	Browns Cambridge is a children friendly coffee shop serving english food near Crowne Plaza Hotel in the riverside area. It has a high customer rating.
"name[Browns Cambridge], eatType[coffee shop], food[English], customer rating[low], area[city centre], familyFriendly[no], near[Crowne Plaza Hotel]"	Browns Cambridge is a coffee shop serving english food near Crowne Plaza Hotel in the city centre. It has a low customer rating and is not family-friendly.
"name[Browns Cambridge], eatType[coffee shop], food[English], customer rating[low], area[city centre], familyFriendly[yes], near[Crowne Plaza Hotel]"	Browns Cambridge is a family-friendly coffee shop serving english food near Crowne Plaza Hotel in the city centre with a low customer rating.
"name[Browns Cambridge], eatType[coffee shop], food[English], customer rating[low], area[riverside], familyFriendly[no], near[Crowne Plaza Hotel]"	Browns Cambridge is a coffee shop serving english food near Crowne Plaza Hotel in the riverside area. It has a low customer rating and is not family-friendly.
"name[Browns Cambridge], eatType[coffee shop], food[English], customer rating[low], area[riverside], familyFriendly[yes], near[Crowne Plaza Hotel]"	Browns Cambridge is a family friendly coffee shop serving english food near Crowne Plaza Hotel in the riverside area. It has a low customer rating.
"name[Clowns], eatType[coffee shop], food[Chinese], customer rating[1 out of 5], area[riverside], near[Clare Hall]"	Clowns is a coffee shop serving chinese food in the riverside area near Clare Hall. It has a customer rating of 1 out of 5.
"name[Clowns], eatType[coffee shop], food[Chinese], customer rating[3 out of 5], area[riverside], near[Clare Hall]"	Clowns is a coffee shop serving chinese food in the riverside area near Clare Hall. It has a customer rating of 3 out of 5.
"name[Clowns], eatType[coffee shop], food[Chinese], customer rating[5 out of 5], area[city centre], near[Clare Hall]"	Clowns is a coffee shop serving chinese food with a customer rating of 5 out of 5. It is located in the city centre near Clare Hall.
"name[Clowns], eatType[coffee shop], food[Chinese], customer rating[5 out of 5], area[riverside], near[Clare Hall]"	Clowns is a coffee shop providing chinese food it is located in the riverside. It is near Clare Hall. Its customer rating is 5 out of 5.
"name[Clowns], eatType[coffee shop], food[Chinese], customer rating[average], area[city centre], near[Clare Hall]"	Clowns is a chinese coffee shop located in the city centre near Clare Hall. It has an average customer rating.
"name[Clowns], eatType[coffee shop], food[Chinese], customer rating[average], area[riverside], near[Clare Hall]"	Clowns is a chinese coffee shop located in the riverside area near Clare Hall. It has an average customer rating.
"name[Clowns], eatType[coffee shop], food[Chinese], customer rating[high], area[riverside], near[Clare Hall]"	Clowns is a highly rated coffee shop that serves chinese food in the riverside area near Clare Hall.
"name[Clowns], eatType[coffee shop], food[Chinese], customer rating[low], area[city centre], near[Clare Hall]"	Clowns is a coffee shop that serves chinese food. It has a low customer rating and is located in the city centre near Clare Hall.
"name[Clowns], eatType[coffee shop], food[Chinese], customer rating[low], area[riverside], near[Clare Hall]"	Clowns is a coffee shop that serves chinese food. It has a low customer rating and is located in the riverside area near Clare Hall.
"name[Clowns], eatType[coffee shop], food[English], customer rating[1 out of 5], area[riverside], near[Clare Hall]"	Clowns is a coffee shop providing english food in the riverside area near Clare Hall. It has a customer rating of 1 out of 5.
"name[Clowns], eatType[coffee shop], food[English], customer rating[3 out of 5], area[riverside], near[Clare Hall]"	Clowns is a coffee shop serving english food near Clare Hall in the riverside area. It has a customer rating of 3 out of 5.
"name[Clowns], eatType[coffee shop], food[English], customer rating[5 out of 5], area[city centre], near[Clare Hall]"	Clowns is an english coffee shop near Clare Hall in the city centre. It has a customer rating of 5 out of 5.
"name[Clowns], eatType[coffee shop], food[English], customer rating[5 out of 5], area[riverside], near[Clare Hall]"	Clowns is an english coffee shop near Clare Hall in the riverside area. It has a customer rating of 5 out of 5.
"name[Clowns], eatType[coffee shop], food[English], customer rating[average], area[city centre], near[Clare Hall]"	Clowns is an average rated english coffee shop near Clare Hall in the city centre.
"name[Clowns], eatType[coffee shop], food[English], customer rating[average], area[riverside], near[Clare Hall]"	Clowns is a coffee shop serving english food near Clare Hall in the riverside area. It has an average customer rating.
"name[Clowns], eatType[coffee shop], food[English], customer rating[high], area[riverside], near[Clare Hall]"	Clowns is a highly rated coffee shop that serves english food near Clare Hall in the riverside area.
"name[Clowns], eatType[coffee shop], food[English], customer rating[low], area[city centre], near[Clare Hall]"	Clowns is a coffee shop located in the city centre near Clare Hall. It serves english food and has a low customer rating.
"name[Clowns], eatType[coffee shop], food[English], customer rating[low], area[riverside], near[Clare Hall]"	Clowns is a low - rated coffee shop located near Clare Hall.
"name[Cocum], eatType[coffee shop], food[Chinese], priceRange[£20-25], customer rating[high], familyFriendly[no]"	Cocum is a chinese coffee shop with a price range of £20-25. It has a high customer rating and is not kid friendly.
"name[Cocum], eatType[coffee shop], food[Chinese], priceRange[£20-25], customer rating[high], familyFriendly[yes]"	Cocum is a highly rated, kid friendly coffee shop that serves moderately priced chinese food.
"name[Cocum], eatType[coffee shop], food[Chinese], priceRange[cheap], customer rating[5 out of 5], familyFriendly[no]"	Cocum is a cheap chinese coffee shop with a customer rating of 5 out of 5 and is not family friendly.
"name[Cocum], eatType[coffee shop], food[Chinese], priceRange[cheap], customer rating[5 out of 5], familyFriendly[yes]"	Cocum is a cheap, family friendly coffee shop serving chinese food with a 5 out of 5 customer rating.
"name[Cocum], eatType[coffee shop], food[Chinese], priceRange[cheap], customer rating[average], familyFriendly[no]"	Cocum is a cheap chinese coffee shop with an average customer rating and is not family friendly.
"name[Cocum], eatType[coffee shop], food[Chinese], priceRange[cheap], customer rating[average], familyFriendly[yes]"	Cocum is a cheap, family friendly coffee shop that serves chinese food and has an average customer rating.
"name[Cocum], eatType[coffee shop], food[Chinese], priceRange[high], customer rating[1 out of 5], familyFriendly[no]"	Cocum is a high priced chinese coffee shop with a customer rating of 1 out of 5. It is not children friendly.
"name[Cocum], eatType[coffee shop], food[Chinese], priceRange[high], customer rating[1 out of 5], familyFriendly[yes]"	Cocum is a high priced coffee shop that serves chinese food. It is child friendly and has a customer rating of 1 out of 5.
"name[Cocum], eatType[coffee shop], food[Chinese], priceRange[high], customer rating[average], familyFriendly[no]"	Cocum is a high priced chinese coffee shop with an average customer rating and is not child friendly.
"name[Cocum], eatType[coffee shop], food[Chinese], priceRange[high], customer rating[average], familyFriendly[yes]"	Cocum is a high priced coffee shop that serves chinese food. It has an average customer rating and is child friendly.
"name[Cocum], eatType[coffee shop], food[Chinese], priceRange[less than £20], customer rating[low], familyFriendly[no]"	Cocum is a low-priced chinese coffee shop with a low customer rating. It is not family friendly.
"name[Cocum], eatType[coffee shop], food[Chinese], priceRange[less than £20], customer rating[low], familyFriendly[yes]"	Cocum is a low rated, family friendly coffee shop that serves chinese food for less than £20.
"name[Cocum], eatType[coffee shop], food[Chinese], priceRange[moderate], customer rating[1 out of 5], familyFriendly[no]"	Cocum is a moderately priced chinese coffee shop with a customer rating of 1 out of 5. It is not kid friendly.
"name[Cocum], eatType[coffee shop], food[Chinese], priceRange[moderate], customer rating[1 out of 5], familyFriendly[yes]"	Cocum is a kid friendly coffee shop that serves moderately priced chinese food with a customer rating of 1 out of 5.
"name[Cocum], eatType[coffee shop], food[Chinese], priceRange[moderate], customer rating[3 out of 5], familyFriendly[no]"	Cocum is a moderately priced chinese coffee shop with a customer rating of 3 out of 5. It is not kid friendly.
"name[Cocum], eatType[coffee shop], food[Chinese], priceRange[moderate], customer rating[3 out of 5], familyFriendly[yes]"	Cocum is a kid friendly coffee shop serving moderately priced chinese food with a customer rating of 3 out of 5.
"name[Cocum], eatType[coffee shop], food[Chinese], priceRange[more than £30], customer rating[high], familyFriendly[no]"	Cocum is a chinese coffee shop with a high customer rating and a price range of more than £30. It is not children friendly.
"name[Cocum], eatType[coffee shop], food[Chinese], priceRange[more than £30], customer rating[high], familyFriendly[yes]"	Cocum is a highly rated, child friendly coffee shop that serves expensive chinese food.
"name[Cocum], eatType[coffee shop], food[English], priceRange[£20-25], customer rating[high], familyFriendly[no]"	Cocum is an english coffee shop with a price range of £20-25. It has a high customer rating and is not kid friendly.
"name[Cocum], eatType[coffee shop], food[English], priceRange[£20-25], customer rating[high], familyFriendly[yes]"	Cocum is a kid friendly coffee shop serving english food with a high customer rating and a price range of £20-25.
"name[Cocum], eatType[coffee shop], food[English], priceRange[cheap], customer rating[5 out of 5], familyFriendly[no]"	Cocum is a cheap coffee shop serving english food with a customer rating of 5 out of 5. It is not family-friendly.
"name[Cocum], eatType[coffee shop], food[English], priceRange[cheap], customer rating[5 out of 5], familyFriendly[yes]"	Cocum is a family friendly coffee shop serving cheap english food with a 5 out of 5 customer rating.
"name[Cocum], eatType[coffee shop], food[English], priceRange[cheap], customer rating[average], familyFriendly[no]"	Cocum is a cheap english coffee shop with an average customer rating. It is not family-friendly.
"name[Cocum], eatType[coffee shop], food[English], priceRange[cheap], customer rating[average], familyFriendly[yes]"	Cocum is a cheap family friendly coffee shop serving english food. It has an average customer rating.
"name[Cocum], eatType[coffee shop], food[English], priceRange[high], customer rating[1 out of 5], familyFriendly[no]"	Cocum is a high priced coffee shop serving english food. It has a customer rating of 1 out of 5 and is not child friendly.
"name[Cocum], eatType[coffee shop], food[English], priceRange[high], customer rating[1 out of 5], familyFriendly[yes]"	Cocum is a children friendly coffee shop serving english food. It has a high price range and a customer rating of 1 out of 5.
"name[Cocum], eatType[coffee shop], food[English], priceRange[high], customer rating[average], familyFriendly[no]"	Cocum is a high priced coffee shop serving english food. It has an average customer rating and is not child friendly.
"name[Cocum], eatType[coffee shop], food[English], priceRange[high], customer rating[average], familyFriendly[yes]"	Cocum is an expensive, family friendly coffee shop with an average rating.
"name[Cocum], eatType[coffee shop], food[English], priceRange[less than £20], customer rating[low], familyFriendly[no]"	Cocum is a low-priced coffee shop serving english food. It is not family-friendly and has a low customer rating.
"name[Cocum], eatType[coffee shop], food[English], priceRange[less than £20], customer rating[low], familyFriendly[yes]"	Cocum is a family friendly coffee shop serving english food in the low price range.
"name[Cocum], eatType[coffee shop], food[English], priceRange[moderate], customer rating[1 out of 5], familyFriendly[no]"	Cocum is a moderately priced coffee shop serving english food. It has a customer rating of 1 out of 5 and is not kid friendly.
"name[Cocum], eatType[coffee shop], food[English], priceRange[moderate], customer rating[1 out of 5], familyFriendly[yes]"	Cocum is a kid friendly coffee shop that serves moderately priced english food with a customer rating of 1 out of 5.
"name[Cocum], eatType[coffee shop], food[English], priceRange[moderate], customer rating[3 out of 5], familyFriendly[no]"	Cocum is a moderately priced coffee shop serving english food. It has a customer rating of 3 out of 5 and is not kid friendly.
"name[Cocum], eatType[coffee shop], food[English], priceRange[moderate], customer rating[3 out of 5], familyFriendly[yes]"	Cocum is a kid friendly coffee shop serving moderately priced english food with a customer rating of 3 out of 5.
"name[Cotto], eatType[coffee shop], food[Chinese], priceRange[£20-25], customer rating[high], area[city centre], near[The Portland Arms]"	Cotto is a coffee shop providing chinese food in the £20-25 price range. It is located in the city centre. It is near The Portland Arms. Its customer rating is high.
"name[Cotto], eatType[coffee shop], food[Chinese], priceRange[£20-25], customer rating[high], area[riverside], near[The Portland Arms]"	Cotto is a coffee shop providing chinese food in the £20-25 price range. It is located in the riverside. It is near The Portland Arms. Its customer rating is high.
"name[Cotto], eatType[coffee shop], food[Chinese], priceRange[cheap], customer rating[5 out of 5], area[city centre], near[The Portland Arms]"	Cotto is a cheap chinese coffee shop located in the city centre near The Portland Arms. It has a customer rating of 5 out of 5.
"name[Cotto], eatType[coffee shop], food[Chinese], priceRange[cheap], customer rating[5 out of 5], area[riverside], near[The Portland Arms]"	Cotto is a coffee shop providing chinese food in the cheap price range. It is located in the riverside. It is near The Portland Arms. Its customer rating is 5 out of 5.
"name[Cotto], eatType[coffee shop], food[Chinese], priceRange[cheap], customer rating[average], area[city centre], near[The Portland Arms]"	Cotto is a coffee shop providing chinese food in the cheap price range. It is located in the city centre. It is near The Portland Arms. Its customer rating is average.
"name[Cotto], eatType[coffee shop], food[Chinese], priceRange[cheap], customer rating[average], area[riverside], near[The Portland Arms]"	Cotto is a coffee shop providing chinese food in the cheap price range. It is located in the riverside. It is near The Portland Arms. Its customer rating is average.
"name[Cotto], eatType[coffee shop], food[Chinese], priceRange[high], customer rating[1 out of 5], area[city centre], near[The Portland Arms]"	Cotto is a coffee shop providing chinese food in the high price range. It is located in the city centre. It is near The Portland Arms. Its customer rating is 1 out of 5.
"name[Cotto], eatType[coffee shop], food[Chinese], priceRange[high], customer rating[1 out of 5], area[riverside], near[The Portland Arms]"	Cotto is a coffee shop providing chinese food in the high price range. It is located in the riverside. It is near The Portland Arms. Its customer rating is 1 out of 5.
"name[Cotto], eatType[coffee shop], food[Chinese], priceRange[high], customer rating[average], area[city centre], near[The Portland Arms]"	Cotto is a high priced chinese coffee shop located in the city centre near The Portland Arms. It has an average customer rating.
"name[Cotto], eatType[coffee shop], food[Chinese], priceRange[high], customer rating[average], area[riverside], near[The Portland Arms]"	Cotto is a high priced chinese coffee shop located in the riverside area near The Portland Arms. It has an average customer rating.
"name[Cotto], eatType[coffee shop], food[Chinese], priceRange[less than £20], customer rating[low], area[city centre], near[The Portland Arms]"	Cotto is a coffee shop providing chinese food in the less than £20 price range. It is located in the city centre. It is near The Portland Arms. Its customer rating is low.
"name[Cotto], eatType[coffee shop], food[Chinese], priceRange[less than £20], customer rating[low], area[riverside], near[The Portland Arms]"	Cotto is a coffee shop providing chinese food in the less than £20 price range. It is located in the riverside. It is near The Portland Arms. Its customer rating is low.
"name[Cotto], eatType[coffee shop], food[Chinese], priceRange[moderate], customer rating[1 out of 5], area[city centre], near[The Portland Arms]"	Cotto is a coffee shop providing chinese food in the moderate price range. It is located in the city centre. It is near The Portland Arms. Its customer rating is 1 out of 5.
"name[Cotto], eatType[coffee shop], food[Chinese], priceRange[moderate], customer rating[1 out of 5], area[riverside], near[The Portland Arms]"	Cotto is a coffee shop providing chinese food in the moderate price range. It is located in the riverside. It is near The Portland Arms. Its customer rating is 1 out of 5.
"name[Cotto], eatType[coffee shop], food[Chinese], priceRange[moderate], customer rating[3 out of 5], area[city centre], near[The Portland Arms]"	Cotto is a coffee shop providing chinese food in the moderate price range. It is located in the city centre. It is near The Portland Arms. Its customer rating is 3 out of 5.
"name[Cotto], eatType[coffee shop], food[Chinese], priceRange[moderate], customer rating[3 out of 5], area[riverside], near[The Portland Arms]"	Cotto is a coffee shop providing chinese food in the moderate price range. It is located in the riverside. It is near The Portland Arms. Its customer rating is 3 out of 5.
"name[Cotto], eatType[coffee shop], food[Chinese], priceRange[more than £30], customer rating[high], area[city centre], near[The Portland Arms]"	Cotto is a coffee shop providing chinese food in the more than £30 price range. It is located in the city centre. It is near The Portland Arms. Its customer rating is high.
"name[Cotto], eatType[coffee shop], food[Chinese], priceRange[more than £30], customer rating[high], area[riverside], near[The Portland Arms]"	Cotto is a coffee shop providing chinese food in the more than £30 price range. It is located in the riverside. It is near The Portland Arms. Its customer rating is high.
"name[Cotto], eatType[coffee shop], food[English], priceRange[£20-25], customer rating[high], area[city centre], near[The Portland Arms]"	Cotto is a coffee shop providing english food in the £20-25 price range. It is located in the city centre near The Portland Arms. Its customer rating is high.
"name[Cotto], eatType[coffee shop], food[English], priceRange[£20-25], customer rating[high], area[riverside], near[The Portland Arms]"	Cotto is a coffee shop that serves english food with a price range of £20-25. It has a high customer rating and is located in the riverside area near The Portland Arms.
"name[Cotto], eatType[coffee shop], food[English], priceRange[cheap], customer rating[5 out of 5], area[city centre], near[The Portland Arms]"	Cotto is a coffee shop providing english food in the cheap price range. It is located in the city centre near The Portland Arms. Its customer rating is 5 out of 5.
"name[Cotto], eatType[coffee shop], food[English], priceRange[cheap], customer rating[5 out of 5], area[riverside], near[The Portland Arms]"	Cotto is a cheap coffee shop near The Portland Arms in the riverside area. It serves english food and has a customer rating of 5 out of 5.
"name[Cotto], eatType[coffee shop], food[English], priceRange[cheap], customer rating[average], area[city centre], near[The Portland Arms]"	Cotto is a cheap coffee shop serving english food near The Portland Arms in the city centre. It has an average customer rating.
"name[Cotto], eatType[coffee shop], food[English], priceRange[cheap], customer rating[average], area[riverside], near[The Portland Arms]"	Cotto is a cheap coffee shop serving english food near The Portland Arms in the riverside area. It has an average customer rating.
"name[Cotto], eatType[coffee shop], food[English], priceRange[high], customer rating[1 out of 5], area[city centre], near[The Portland Arms]"	Cotto is a coffee shop providing english food in the high price range. It is located in the city centre. It is near The Portland Arms. Its customer rating is 1 out of 5.
"name[Cotto], eatType[coffee shop], food[English], priceRange[high], customer rating[1 out of 5], area[riverside], near[The Portland Arms]"	Cotto is a high priced coffee shop that serves english food. It is located in the riverside area near The Portland Arms. It has a customer rating of 1 out of 5.
"name[Cotto], eatType[coffee shop], food[English], priceRange[high], customer rating[average], area[city centre], near[The Portland Arms]"	Cotto is an english coffee shop near The Portland Arms in the city centre. It has a high price range and an average customer rating.
"name[Cotto], eatType[coffee shop], food[English], priceRange[high], customer rating[average], area[riverside], near[The Portland Arms]"	Cotto is a high priced coffee shop that serves english food. It has an average customer rating and is located in the riverside area near The Portland Arms.
"name[Cotto], eatType[coffee shop], food[English], priceRange[less than £20], customer rating[low], area[city centre], near[The Portland Arms]"	Cotto is a coffee shop providing english food in the less than £20 price range. It is located in the city centre. It is near The Portland Arms. Its customer rating is low.
"name[Cotto], eatType[coffee shop], food[English], priceRange[less than £20], customer rating[low], area[riverside], near[The Portland Arms]"	Cotto is a low-priced coffee shop that serves english food. It is located in the riverside area near The Portland Arms. It has a low customer rating.
"name[Cotto], eatType[coffee shop], food[English], priceRange[moderate], customer rating[1 out of 5], area[city centre], near[The Portland Arms]"	Cotto is a coffee shop providing english food in the moderate price range. It is located in the city centre near The Portland Arms. Its customer rating is 1 out of 5.
"name[Cotto], eatType[coffee shop], food[English], priceRange[moderate], customer rating[1 out of 5], area[riverside], near[The Portland Arms]"	Cotto is a moderately priced coffee shop serving english food near The Portland Arms in the riverside area. It has a customer rating of 1 out of 5.
"name[Cotto], eatType[coffee shop], food[English], priceRange[moderate], customer rating[3 out of 5], area[city centre], near[The Portland Arms]"	Cotto is a coffee shop providing english food in the moderate price range. It is located in the city centre near The Portland Arms.
"name[Cotto], eatType[coffee shop], food[English], priceRange[moderate], customer rating[3 out of 5], area[riverside], near[The Portland Arms]"	Cotto is a moderately priced coffee shop near The Portland Arms in the riverside area. It serves english food and has a customer rating of 3 out of 5.
"name[Cotto], eatType[coffee shop], food[English], priceRange[more than £30], customer rating[high], area[city centre], near[The Portland Arms]"	Cotto is a coffee shop providing english food in the more than £30 price range. It is located in the city centre. It is near The Portland Arms. Its customer rating is high.
"name[Fitzbillies], eatType[coffee shop], food[Chinese], priceRange[£20-25], customer rating[high], area[city centre], familyFriendly[no]"	Fitzbillies is a coffee shop serving chinese food in the £20-25 price range. It has a high customer rating and is located in the city centre. It is not kid friendly.
"name[Fitzbillies], eatType[coffee shop], food[Chinese], priceRange[£20-25], customer rating[high], area[city centre], familyFriendly[yes]"	Fitzbillies is a coffee shop providing chinese food in the £20-25 price range. It is located in the city centre. Its customer rating is high.
"name[Fitzbillies], eatType[coffee shop], food[Chinese], priceRange[£20-25], customer rating[high], area[riverside], familyFriendly[no]"	Fitzbillies is a chinese coffee shop in the riverside area with a price range of £20-25. It has a high customer rating and is not kid friendly.
"name[Fitzbillies], eatType[coffee shop], food[Chinese], priceRange[£20-25], customer rating[high], area[riverside], familyFriendly[yes]"	Fitzbillies is a coffee shop providing chinese food in the £20-25 price range. It is located in the riverside. Its customer rating is high.
"name[Fitzbillies], eatType[coffee shop], food[Chinese], priceRange[cheap], customer rating[5 out of 5], area[city centre], familyFriendly[no]"	Fitzbillies is a cheap coffee shop serving chinese food in the city centre. It has a customer rating of 5 out of 5 and is not family friendly.
"name[Fitzbillies], eatType[coffee shop], food[Chinese], priceRange[cheap], customer rating[5 out of 5], area[city centre], familyFriendly[yes]"	Fitzbillies is a cheap, family friendly chinese coffee shop located in the city centre. It has a customer rating of 5 out of 5.
"name[Fitzbillies], eatType[coffee shop], food[Chinese], priceRange[cheap], customer rating[5 out of 5], area[riverside], familyFriendly[no]"	Fitzbillies is a cheap chinese coffee shop in the riverside area. It has a customer rating of 5 out of 5 and is not family friendly.
"name[Fitzbillies], eatType[coffee shop], food[Chinese], priceRange[cheap], customer rating[5 out of 5], area[riverside], familyFriendly[yes]"	Fitzbillies is a cheap, family friendly chinese coffee shop in the riverside area with a customer rating of 5 out of 5.
"name[Fitzbillies], eatType[coffee shop], food[Chinese], priceRange[cheap], customer rating[average], area[city centre], familyFriendly[no]"	Fitzbillies is a cheap chinese coffee shop located in the city centre. It has an average customer rating and is not family friendly.
"name[Fitzbillies], eatType[coffee shop], food[Chinese], priceRange[cheap], customer rating[average], area[city centre], familyFriendly[yes]"	Fitzbillies is a cheap, family friendly chinese coffee shop located in the city centre. It has an average customer rating.
"name[Fitzbillies], eatType[coffee shop], food[Chinese], priceRange[cheap], customer rating[average], area[riverside], familyFriendly[no]"	Fitzbillies is a cheap chinese coffee shop in the riverside area. It has an average customer rating and is not family friendly.
"name[Fitzbillies], eatType[coffee shop], food[Chinese], priceRange[cheap], customer rating[average], area[riverside], familyFriendly[yes]"	Fitzbillies is a cheap, family friendly chinese coffee shop in the riverside area with an average customer rating.
"name[Fitzbillies], eatType[coffee shop], food[Chinese], priceRange[high], customer rating[1 out of 5], area[city centre], familyFriendly[no]"	Fitzbillies is a coffee shop that provides chinese food in the high price range. It is located in the city centre. Its customer rating is 1 out of 5 and is not child friendly.
"name[Fitzbillies], eatType[coffee shop], food[Chinese], priceRange[high], customer rating[1 out of 5], area[city centre], familyFriendly[yes]"	Fitzbillies is a coffee shop providing chinese food in the high price range. It is located in the city centre. Its customer rating is 1 out of 5.
"name[Fitzbillies], eatType[coffee shop], food[Chinese], priceRange[high], customer rating[1 out of 5], area[riverside], familyFriendly[no]"	Fitzbillies is a high priced chinese coffee shop in the riverside area. It has a customer rating of 1 out of 5 and is not children friendly.
"name[Fitzbillies], eatType[coffee shop], food[Chinese], priceRange[high], customer rating[1 out of 5], area[riverside], familyFriendly[yes]"	Fitzbillies is a coffee shop providing chinese food in the high price range. It is located in the riverside. Its customer rating is 1 out of 5.
"name[Fitzbillies], eatType[coffee shop], food[Chinese], priceRange[high], customer rating[average], area[city centre], familyFriendly[no]"	Fitzbillies is a high priced chinese coffee shop located in the city centre. It has an average customer rating and is not child friendly.
"name[Fitzbillies], eatType[coffee shop], food[Chinese], priceRange[high], customer rating[average], area[city centre], familyFriendly[yes]"	Fitzbillies is a high priced chinese coffee shop located in the city centre. It has an average customer rating and is child friendly.
"name[Fitzbillies], eatType[coffee shop], food[Chinese], priceRange[high], customer rating[average], area[riverside], familyFriendly[no]"	Fitzbillies is a high priced chinese coffee shop in the riverside area. It has an average customer rating and is not children friendly.
"name[Fitzbillies], eatType[coffee shop], food[Chinese], priceRange[high], customer rating[average], area[riverside], familyFriendly[yes]"	Fitzbillies is a high priced chinese coffee shop in the riverside area. It has an average customer rating and is children friendly.
"name[Fitzbillies], eatType[coffee shop], food[Chinese], priceRange[less than £20], customer rating[low], area[city centre], familyFriendly[no]"	Fitzbillies is a coffee shop providing chinese food in the less than £20 price range. It is located in the city centre. Its customer rating is low.
"name[Fitzbillies], eatType[coffee shop], food[Chinese], priceRange[less than £20], customer rating[low], area[city centre], familyFriendly[yes]"	Fitzbillies is a coffee shop providing chinese food in the less than £20 price range. It is located in the city centre. Its customer rating is low.
"name[Fitzbillies], eatType[coffee shop], food[Chinese], priceRange[less than £20], customer rating[low], area[riverside], familyFriendly[no]"	Fitzbillies is a coffee shop providing chinese food in the less than £20 price range. It is located in the riverside. Its customer rating is low. It is not family friendly.
"name[Fitzbillies], eatType[coffee shop], food[Chinese], priceRange[less than £20], customer rating[low], area[riverside], familyFriendly[yes]"	Fitzbillies is a coffee shop providing chinese food in the less than £20 price range. It is located in the riverside. Its customer rating is low. It is a family friendly restaurant.
"name[Fitzbillies], eatType[coffee shop], food[Chinese], priceRange[moderate], customer rating[1 out of 5], area[city centre], familyFriendly[no]"	Fitzbillies is a moderately priced chinese coffee shop located in the city centre. It has a customer rating of 1 out of 5 and is not kid friendly.
"name[Fitzbillies], eatType[coffee shop], food[Chinese], priceRange[moderate], customer rating[1 out of 5], area[city centre], familyFriendly[yes]"	Fitzbillies is a coffee shop providing chinese food in the moderate price range. It is located in the city centre. Its customer rating is 1 out of 5.
"name[Fitzbillies], eatType[coffee shop], food[Chinese], priceRange[moderate], customer rating[1 out of 5], area[riverside], familyFriendly[no]"	Fitzbillies is a moderately priced chinese coffee shop in the riverside area. It has a customer rating of 1 out of 5 and is not kid friendly.
"name[Fitzbillies], eatType[coffee shop], food[Chinese], priceRange[moderate], customer rating[1 out of 5], area[riverside], familyFriendly[yes]"	Fitzbillies is a coffee shop providing chinese food in the moderate price range. It is located in the riverside. Its customer rating is 1 out of 5.
"name[Fitzbillies], eatType[coffee shop], food[Chinese], priceRange[moderate], customer rating[3 out of 5], area[city centre], familyFriendly[no]"	Fitzbillies is a moderately priced chinese coffee shop located in the city centre. It has a customer rating of 3 out of 5 and is not kid friendly.
"name[Fitzbillies], eatType[coffee shop], food[Chinese], priceRange[moderate], customer rating[3 out of 5], area[city centre], familyFriendly[yes]"	Fitzbillies is a coffee shop serving chinese food in the moderate price range. It is located in the city centre. It has a customer rating of 3 out of 5 and is kid friendly.
"name[Fitzbillies], eatType[coffee shop], food[Chinese], priceRange[moderate], customer rating[3 out of 5], area[riverside], familyFriendly[no]"	Fitzbillies is a moderately priced chinese coffee shop in the riverside area. It has a customer rating of 3 out of 5 and is not kid friendly.
"name[Fitzbillies], eatType[coffee shop], food[Chinese], priceRange[moderate], customer rating[3 out of 5], area[riverside], familyFriendly[yes]"	Fitzbillies is a coffee shop providing chinese food in the moderate price range. It is located in the riverside. Its customer rating is 3 out of 5.
"name[Fitzbillies], eatType[coffee shop], food[Chinese], priceRange[more than £30], customer rating[high], area[city centre], familyFriendly[no]"	Fitzbillies is a coffee shop providing chinese food in the more than £30 price range. It is located in the city centre. Its customer rating is high.
"name[Fitzbillies], eatType[coffee shop], food[Chinese], priceRange[more than £30], customer rating[high], area[city centre], familyFriendly[yes]"	Fitzbillies is a coffee shop providing chinese food in the more than £30 price range. It is located in the city centre. Its customer rating is high.
"name[Fitzbillies], eatType[coffee shop], food[Chinese], priceRange[more than £30], customer rating[high], area[riverside], familyFriendly[no]"	Fitzbillies is a coffee shop providing chinese food in the more than £30 price range. It is located in the riverside. Its customer rating is high. Its no children allowed.
"name[Fitzbillies], eatType[coffee shop], food[Chinese], priceRange[more than £30], customer rating[high], area[riverside], familyFriendly[yes]"	Fitzbillies is a highly rated, child friendly, high priced, chinese coffee shop in the riverside area.
"name[Fitzbillies], eatType[coffee shop], food[English], priceRange[£20-25], customer rating[high], area[city centre], familyFriendly[no]"	Fitzbillies is a coffee shop serving english food in the £20-25 price range. It is located in the city centre and has a high customer rating. It is not kid friendly.
"name[Fitzbillies], eatType[coffee shop], food[English], priceRange[£20-25], customer rating[high], area[city centre], familyFriendly[yes]"	Fitzbillies is a kid friendly coffee shop serving english food in the £20-25 price range. It has a high customer rating and is located in the city centre.
"name[Fitzbillies], eatType[coffee shop], food[English], priceRange[£20-25], customer rating[high], area[riverside], familyFriendly[no]"	Fitzbillies is a coffee shop providing english food in the £20-25 price range. It is located in the riverside. Its customer rating is high.
"name[Fitzbillies], eatType[coffee shop], food[English], priceRange[£20-25], customer rating[high], area[riverside], familyFriendly[yes]"	Fitzbillies is a kid friendly coffee shop serving english food in the riverside area. It has a high customer rating and a price range of £20-25.
"name[Fitzbillies], eatType[coffee shop], food[English], priceRange[cheap], customer rating[5 out of 5], area[city centre], familyFriendly[no]"	Fitzbillies is a cheap english coffee shop in the city centre. It has a customer rating of 5 out of 5 and is not family-friendly.
"name[Fitzbillies], eatType[coffee shop], food[English], priceRange[cheap], customer rating[5 out of 5], area[city centre], familyFriendly[yes]"	Fitzbillies is a family-friendly coffee shop serving cheap english food in the city centre with a customer rating of 5 out of 5.
"name[Fitzbillies], eatType[coffee shop], food[English], priceRange[cheap], customer rating[5 out of 5], area[riverside], familyFriendly[no]"	Fitzbillies is a cheap english coffee shop in the riverside area. It has a customer rating of 5 out of 5 and is not family-friendly.
"name[Fitzbillies], eatType[coffee shop], food[English], priceRange[cheap], customer rating[5 out of 5], area[riverside], familyFriendly[yes]"	Fitzbillies is a family friendly coffee shop serving cheap english food in the riverside area with a customer rating of 5 out of 5.
"name[Fitzbillies], eatType[coffee shop], food[English], priceRange[cheap], customer rating[average], area[city centre], familyFriendly[no]"	Fitzbillies is a cheap english coffee shop in the city centre. It has an average customer rating and is not family-friendly.
"name[Fitzbillies], eatType[coffee shop], food[English], priceRange[cheap], customer rating[average], area[city centre], familyFriendly[yes]"	Fitzbillies is a family-friendly coffee shop serving cheap english food in the city centre with an average customer rating.
"name[Fitzbillies], eatType[coffee shop], food[English], priceRange[cheap], customer rating[average], area[riverside], familyFriendly[no]"	Fitzbillies is a cheap english coffee shop in the riverside area. It has an average customer rating and is not family-friendly.
"name[Fitzbillies], eatType[coffee shop], food[English], priceRange[cheap], customer rating[average], area[riverside], familyFriendly[yes]"	Fitzbillies is a cheap family friendly coffee shop in the riverside area. It serves english food and has an average customer rating.
"name[Fitzbillies], eatType[coffee shop], food[English], priceRange[high], customer rating[1 out of 5], area[city centre], familyFriendly[no]"	Fitzbillies is a coffee shop providing english food in the high price range. It is located in the city centre. Its customer rating is 1 out of 5 and is not child friendly.
"name[Fitzbillies], eatType[coffee shop], food[English], priceRange[high], customer rating[1 out of 5], area[city centre], familyFriendly[yes]"	Fitzbillies is a coffee shop providing english food in the high price range. It is located in the city centre. It is children friendly and has a customer rating of 1 out of 5.
"name[Fitzbillies], eatType[coffee shop], food[English], priceRange[high], customer rating[1 out of 5], area[riverside], familyFriendly[no]"	Fitzbillies is a coffee shop providing english food in the high price range. It is located in the riverside. Its customer rating is 1 out of 5 and is not children friendly.
"name[Fitzbillies], eatType[coffee shop], food[English], priceRange[high], customer rating[1 out of 5], area[riverside], familyFriendly[yes]"	Fitzbillies is a children friendly coffee shop serving english food in the riverside area. It has a high price range and a customer rating of 1 out of 5.
"name[Fitzbillies], eatType[coffee shop], food[English], priceRange[high], customer rating[average], area[city centre], familyFriendly[no]"	Fitzbillies is a high priced coffee shop serving english food in the city centre. It has an average customer rating and is not child friendly.
"name[Fitzbillies], eatType[coffee shop], food[English], priceRange[high], customer rating[average], area[city centre], familyFriendly[yes]"	Fitzbillies is a child friendly coffee shop serving english food in the high price range. It has an average customer rating and is located in the city centre.
"name[Fitzbillies], eatType[coffee shop], food[English], priceRange[high], customer rating[average], area[riverside], familyFriendly[no]"	Fitzbillies is a high priced coffee shop serving english food in the riverside area. It has an average customer rating and is not child friendly.
"name[Fitzbillies], eatType[coffee shop], food[English], priceRange[high], customer rating[average], area[riverside], familyFriendly[yes]"	Fitzbillies is an expensive, family friendly coffee shop in the riverside area. It serves english food and has an average customer rating.
"name[Fitzbillies], eatType[coffee shop], food[English], priceRange[less than £20], customer rating[low], area[city centre], familyFriendly[no]"	Fitzbillies is a coffee shop providing english food in the less than £20 price range. It is located in the city centre. It is not family-friendly and has a low customer rating.
"name[Fitzbillies], eatType[coffee shop], food[English], priceRange[less than £20], customer rating[low], area[city centre], familyFriendly[yes]"	Fitzbillies is a family-friendly coffee shop that serves english food in the price range of less than £20. It has a low customer rating and is located in the city centre.
"name[Fitzbillies], eatType[coffee shop], food[English], priceRange[less than £20], customer rating[low], area[riverside], familyFriendly[no]"	Fitzbillies is a coffee shop providing english food in the less than £20 price range. It is located in the riverside. Its customer rating is low.
"name[Fitzbillies], eatType[coffee shop], food[English], priceRange[less than £20], customer rating[low], area[riverside], familyFriendly[yes]"	Fitzbillies is a family friendly coffee shop serving english food in the riverside area. It has a low customer rating and a price range of less than £20.
"name[Fitzbillies], eatType[coffee shop], food[English], priceRange[moderate], customer rating[1 out of 5], area[city centre], familyFriendly[no]"	Fitzbillies is a moderately priced coffee shop serving english food in the city centre. It has a customer rating of 1 out of 5 and is not kid friendly.
"name[Fitzbillies], eatType[coffee shop], food[English], priceRange[moderate], customer rating[1 out of 5], area[city centre], familyFriendly[yes]"	Fitzbillies is a kid friendly coffee shop serving english food in the moderate price range. It is located in the city centre and has a customer rating of 1 out of 5.
"name[Fitzbillies], eatType[coffee shop], food[English], priceRange[moderate], customer rating[1 out of 5], area[riverside], familyFriendly[no]"	Fitzbillies is a moderately priced coffee shop serving english food in the riverside area. It has a customer rating of 1 out of 5 and is not kid friendly.
"name[Fitzbillies], eatType[coffee shop], food[English], priceRange[moderate], customer rating[1 out of 5], area[riverside], familyFriendly[yes]"	Fitzbillies is a kid friendly coffee shop serving english food in the moderate price range. It is located in the riverside area and has a customer rating of 1 out of 5.
"name[Fitzbillies], eatType[coffee shop], food[English], priceRange[moderate], customer rating[3 out of 5], area[city centre], familyFriendly[no]"	Fitzbillies is a moderately priced coffee shop serving english food in the city centre. It has a customer rating of 3 out of 5 and is not kid friendly.
"name[Fitzbillies], eatType[coffee shop], food[English], priceRange[moderate], customer rating[3 out of 5], area[city centre], familyFriendly[yes]"	Fitzbillies is a kid friendly coffee shop serving english food in the moderate price range. It is located in the city centre and has a customer rating of 3 out of 5.
"name[Fitzbillies], eatType[coffee shop], food[English], priceRange[moderate], customer rating[3 out of 5], area[riverside], familyFriendly[no]"	Fitzbillies is a moderately priced coffee shop serving english food in the riverside area. It has a customer rating of 3 out of 5 and is not kid friendly.
"name[Fitzbillies], eatType[coffee shop], food[English], priceRange[moderate], customer rating[3 out of 5], area[riverside], familyFriendly[yes]"	Fitzbillies is a kid friendly coffee shop serving english food in the moderate price range. It is located in the riverside area and has a customer rating of 3 out of 5.
"name[Fitzbillies], eatType[coffee shop], food[English], priceRange[more than £30], customer rating[high], area[city centre], familyFriendly[no]"	Fitzbillies is a coffee shop providing english food in the more than £30 price range. It is located in the city centre. Its customer rating is high.
"name[Fitzbillies], eatType[coffee shop], food[English], priceRange[more than £30], customer rating[high], area[city centre], familyFriendly[yes]"	Fitzbillies is a child friendly coffee shop serving english food in the city centre. It has a high customer rating and a price range of more than £30.
"name[Fitzbillies], eatType[coffee shop], food[English], priceRange[more than £30], customer rating[high], area[riverside], familyFriendly[no]"	Fitzbillies is a coffee shop providing english food in the more than £30 price range. It is located in the riverside. Its customer rating is high.
"name[Midsummer House], customer rating[1 out of 5], near[The Bakers]"	Midsummer House has a customer rating of 1 out of 5 and is located near The Bakers.
"name[Midsummer House], customer rating[3 out of 5], near[The Bakers]"	Midsummer House has a customer rating of 3 out of 5 and is located near The Bakers.
"name[Midsummer House], customer rating[5 out of 5], near[The Bakers]"	Midsummer House has a 5 out of 5 customer rating and is near The Bakers.
"name[Midsummer House], customer rating[average], near[The Bakers]"	Midsummer House has an average customer rating near The Bakers.
"name[Midsummer House], customer rating[high], near[The Bakers]"	Midsummer House is near The Bakers and has a high customer rating.
"name[Midsummer House], customer rating[low], near[The Bakers]"	Midsummer House has a low customer rating and is located near The Bakers.
"name[Taste of Cambridge], eatType[coffee shop], food[Chinese], area[city centre], familyFriendly[no], near[Crowne Plaza Hotel]"	Taste of Cambridge is a coffee shop serving chinese food in the city centre near Crowne Plaza Hotel. It is not family friendly.
"name[Taste of Cambridge], eatType[coffee shop], food[Chinese], area[city centre], familyFriendly[yes], near[Crowne Plaza Hotel]"	Taste of Cambridge is a family friendly chinese coffee shop located in the city centre near Crowne Plaza Hotel.
"name[Taste of Cambridge], eatType[coffee shop], food[Chinese], area[riverside], familyFriendly[no], near[Crowne Plaza Hotel]"	Taste of Cambridge is a chinese coffee shop in the riverside area near Crowne Plaza Hotel. It is not family friendly.
"name[Taste of Cambridge], eatType[coffee shop], food[Chinese], area[riverside], familyFriendly[yes], near[Crowne Plaza Hotel]"	Taste of Cambridge is a family friendly chinese coffee shop in the riverside area near Crowne Plaza Hotel.
"name[Taste of Cambridge], eatType[coffee shop], food[English], area[city centre], familyFriendly[no], near[Crowne Plaza Hotel]"	Taste of Cambridge is a non family-friendly coffee shop serving english food near Crowne Plaza Hotel in the city centre.
"name[Taste of Cambridge], eatType[coffee shop], food[English], area[city centre], familyFriendly[yes], near[Crowne Plaza Hotel]"	Taste of Cambridge is a family-friendly coffee shop serving english food in the city centre near Crowne Plaza Hotel.
"name[Taste of Cambridge], eatType[coffee shop], food[English], area[riverside], familyFriendly[no], near[Crowne Plaza Hotel]"	Taste of Cambridge is a coffee shop serving english food near Crowne Plaza Hotel in the riverside area. It is not family-friendly.
"name[Taste of Cambridge], eatType[coffee shop], food[English], area[riverside], familyFriendly[yes], near[Crowne Plaza Hotel]"	Taste of Cambridge is a family friendly coffee shop serving english food near Crowne Plaza Hotel in the riverside area.
"name[The Cambridge Blue], eatType[coffee shop], customer rating[1 out of 5], area[riverside], familyFriendly[yes], near[Burger King]"	The Cambridge Blue is a child friendly coffee shop in the riverside area near Burger King with a customer rating of 1 out of 5.
"name[The Cambridge Blue], eatType[coffee shop], customer rating[3 out of 5], area[riverside], familyFriendly[yes], near[Burger King]"	The Cambridge Blue is a kid friendly coffee shop in the riverside area near Burger King with a customer rating of 3 out of 5.
"name[The Cambridge Blue], eatType[coffee shop], customer rating[5 out of 5], area[city centre], familyFriendly[no], near[Burger King]"	The Cambridge Blue is a coffee shop near Burger King in the city centre. It is not family-friendly and has a customer rating of 5 out of 5.
"name[The Cambridge Blue], eatType[coffee shop], customer rating[5 out of 5], area[city centre], familyFriendly[yes], near[Burger King]"	The Cambridge Blue is a family-friendly coffee shop in the city centre near Burger King with a customer rating of 5 out of 5.
"name[The Cambridge Blue], eatType[coffee shop], customer rating[5 out of 5], area[riverside], familyFriendly[no], near[Burger King]"	The Cambridge Blue is a coffee shop in the riverside area near Burger King. It has a 5 out of 5 customer rating and is not family-friendly.
"name[The Cambridge Blue], eatType[coffee shop], customer rating[5 out of 5], area[riverside], familyFriendly[yes], near[Burger King]"	The Cambridge Blue is a family friendly coffee shop in the riverside area near Burger King with a 5 out of 5 customer rating.
"name[The Cambridge Blue], eatType[coffee shop], customer rating[average], area[city centre], familyFriendly[no], near[Burger King]"	The Cambridge Blue is a coffee shop near Burger King in the city centre. It is not family-friendly and has an average customer rating.
"name[The Cambridge Blue], eatType[coffee shop], customer rating[average], area[city centre], familyFriendly[yes], near[Burger King]"	The Cambridge Blue is a family-friendly coffee shop near Burger King in the city centre. It has an average customer rating.
"name[The Cambridge Blue], eatType[coffee shop], customer rating[average], area[riverside], familyFriendly[no], near[Burger King]"	The Cambridge Blue is a coffee shop in the riverside area near Burger King. It is not family-friendly and has an average customer rating.
"name[The Cambridge Blue], eatType[coffee shop], customer rating[average], area[riverside], familyFriendly[yes], near[Burger King]"	The Cambridge Blue is a family friendly coffee shop in the riverside area near Burger King. It has an average customer rating.
"name[The Cambridge Blue], eatType[coffee shop], customer rating[high], area[riverside], familyFriendly[yes], near[Burger King]"	The Cambridge Blue is a child friendly coffee shop in the riverside area near Burger King with a high customer rating.
"name[The Cambridge Blue], eatType[coffee shop], customer rating[low], area[city centre], familyFriendly[no], near[Burger King]"	The Cambridge Blue is a coffee shop in the city centre near Burger King. It is not family-friendly and has a low customer rating.
"name[The Cambridge Blue], eatType[coffee shop], customer rating[low], area[city centre], familyFriendly[yes], near[Burger King]"	The Cambridge Blue is a family-friendly coffee shop near Burger King in the city centre with a low customer rating.
"name[The Cambridge Blue], eatType[coffee shop], customer rating[low], area[riverside], familyFriendly[no], near[Burger King]"	The Cambridge Blue is a coffee shop in the riverside area near Burger King. It has a low customer rating and is not family-friendly.
"name[The Cambridge Blue], eatType[coffee shop], customer rating[low], area[riverside], familyFriendly[yes], near[Burger King]"	The Cambridge Blue is a family friendly coffee shop in the riverside area near Burger King with a low customer rating.
"name[The Cricketers], eatType[coffee shop], food[Chinese], customer rating[1 out of 5], familyFriendly[yes], near[The Portland Arms]"	The Cricketers is a coffee shop providing chinese food it is located near The Portland Arms. Its customer rating is 1 out of 5.
"name[The Cricketers], eatType[coffee shop], food[Chinese], customer rating[3 out of 5], familyFriendly[yes], near[The Portland Arms]"	The Cricketers is a coffee shop serving chinese food near The Portland Arms. It has a customer rating of 3 out of 5 and is kid friendly.
"name[The Cricketers], eatType[coffee shop], food[Chinese], customer rating[5 out of 5], familyFriendly[no], near[The Portland Arms]"	The Cricketers is a chinese coffee shop near The Portland Arms. It has a customer rating of 5 out of 5 and is not family friendly.
"name[The Cricketers], eatType[coffee shop], food[Chinese], customer rating[5 out of 5], familyFriendly[yes], near[The Portland Arms]"	The Cricketers is a 5 out of 5 rated, family friendly coffee shop that serves chinese food near The Portland Arms.
"name[The Cricketers], eatType[coffee shop], food[Chinese], customer rating[average], familyFriendly[no], near[The Portland Arms]"	The Cricketers is a chinese coffee shop near The Portland Arms. It has an average customer rating and is not family friendly.
"name[The Cricketers], eatType[coffee shop], food[Chinese], customer rating[average], familyFriendly[yes], near[The Portland Arms]"	The Cricketers is a family friendly coffee shop serving chinese food near The Portland Arms. It has an average customer rating.
"name[The Cricketers], eatType[coffee shop], food[Chinese], customer rating[high], familyFriendly[yes], near[The Portland Arms]"	The Cricketers is a children friendly coffee shop that serves highly rated chinese food near The Portland Arms.
"name[The Cricketers], eatType[coffee shop], food[Chinese], customer rating[low], familyFriendly[no], near[The Portland Arms]"	The Cricketers is a coffee shop providing chinese food it is located near The Portland Arms. Its customer rating is low.
"name[The Cricketers], eatType[coffee shop], food[Chinese], customer rating[low], familyFriendly[yes], near[The Portland Arms]"	The Cricketers is a family friendly coffee shop serving chinese food near The Portland Arms. It has a low customer rating.
"name[The Cricketers], eatType[coffee shop], food[English], customer rating[1 out of 5], familyFriendly[yes], near[The Portland Arms]"	The Cricketers is a family friendly coffee shop near The Portland Arms that serves english food and has a customer rating of 1 out of 5.
"name[The Cricketers], eatType[coffee shop], food[English], customer rating[3 out of 5], familyFriendly[yes], near[The Portland Arms]"	The Cricketers is a kids friendly coffee shop serving english food near The Portland Arms with a customer rating of 3 out of 5.
"name[The Cricketers], eatType[coffee shop], food[English], customer rating[5 out of 5], familyFriendly[no], near[The Portland Arms]"	The Cricketers is a coffee shop serving english food near The Portland Arms. It has a customer rating of 5 out of 5 and is not family-friendly.
"name[The Cricketers], eatType[coffee shop], food[English], customer rating[5 out of 5], familyFriendly[yes], near[The Portland Arms]"	The Cricketers is a family friendly coffee shop serving english food near The Portland Arms with a customer rating of 5 out of 5.
"name[The Cricketers], eatType[coffee shop], food[English], customer rating[average], familyFriendly[no], near[The Portland Arms]"	The Cricketers is an average rated english coffee shop near The Portland Arms. It is not family-friendly.
"name[The Cricketers], eatType[coffee shop], food[English], customer rating[average], familyFriendly[yes], near[The Portland Arms]"	The Cricketers is a family friendly coffee shop serving english food near The Portland Arms. It has an average customer rating.
"name[The Cricketers], eatType[coffee shop], food[English], customer rating[high], familyFriendly[yes], near[The Portland Arms]"	The Cricketers is a children friendly coffee shop serving english food near The Portland Arms with a high customer rating.
"name[The Cricketers], eatType[coffee shop], food[English], customer rating[low], familyFriendly[no], near[The Portland Arms]"	The Cricketers is an english coffee shop near The Portland Arms. It has a low customer rating and is not family-friendly.
"name[The Cricketers], eatType[coffee shop], food[English], customer rating[low], familyFriendly[yes], near[The Portland Arms]"	The Cricketers is a family friendly coffee shop serving english food near The Portland Arms with a low customer rating.
"name[The Eagle], customer rating[1 out of 5], area[riverside], familyFriendly[yes], near[Café Brazil]"	The Eagle is a child friendly restaurant in the riverside area near Café Brazil. It has a customer rating of 1 out of 5.
"name[The Eagle], customer rating[3 out of 5], area[riverside], familyFriendly[yes], near[Café Brazil]"	The Eagle is a kid friendly restaurant in the riverside area near Café Brazil with a customer rating of 3 out of 5.
"name[The Eagle], customer rating[5 out of 5], area[city centre], familyFriendly[no], near[Café Brazil]"	The Eagle is located near Café Brazil in the city centre. It has a customer rating of 5 out of 5 and is not family-friendly.
"name[The Eagle], customer rating[5 out of 5], area[city centre], familyFriendly[yes], near[Café Brazil]"	The Eagle is a family-friendly place with a 5 out of 5 customer rating. It is located in the city centre near Café Brazil.
"name[The Eagle], customer rating[5 out of 5], area[riverside], familyFriendly[no], near[Café Brazil]"	The Eagle is near Café Brazil in the riverside area. It has a customer rating of 5 out of 5 and is not family-friendly.
"name[The Eagle], customer rating[5 out of 5], area[riverside], familyFriendly[yes], near[Café Brazil]"	The Eagle is a family friendly restaurant near Café Brazil in the riverside area.
"name[The Eagle], customer rating[average], area[city centre], familyFriendly[no], near[Café Brazil]"	The Eagle is located in the city centre near Café Brazil. It has an average customer rating and is not family-friendly.
"name[The Eagle], customer rating[average], area[city centre], familyFriendly[yes], near[Café Brazil]"	The Eagle is located in the city centre near Café Brazil. It is family-friendly and has an average customer rating.
"name[The Eagle], customer rating[average], area[riverside], familyFriendly[no], near[Café Brazil]"	The Eagle is near Café Brazil in the riverside area. It is not family-friendly and has an average customer rating.
"name[The Eagle], customer rating[average], area[riverside], familyFriendly[yes], near[Café Brazil]"	The Eagle is a family friendly restaurant near Café Brazil in the riverside area. It has an average customer rating.
"name[The Eagle], customer rating[high], area[riverside], familyFriendly[yes], near[Café Brazil]"	The Eagle is a highly rated, child friendly restaurant in the riverside area near Café Brazil.
"name[The Eagle], customer rating[low], area[city centre], familyFriendly[no], near[Café Brazil]"	The Eagle is located near Café Brazil in the city centre. It is not family-friendly and has a low customer rating.
"name[The Eagle], customer rating[low], area[city centre], familyFriendly[yes], near[Café Brazil]"	The Eagle is a family-friendly restaurant near Café Brazil in the city centre with a low customer rating.
"name[The Eagle], customer rating[low], area[riverside], familyFriendly[no], near[Café Brazil]"	The Eagle is located near Café Brazil in the riverside area. It is not family-friendly and has a low customer rating.
"name[The Eagle], customer rating[low], area[riverside], familyFriendly[yes], near[Café Brazil]"	The Eagle is a family friendly restaurant near Café Brazil in the riverside area.
"name[The Eagle], eatType[coffee shop], food[Chinese], priceRange[£20-25], customer rating[high], area[city centre], familyFriendly[no], near[Burger King]"	The Eagle is a coffee shop providing chinese food in the £20-25 price range. It is located in the city centre. It is near Burger King. Its customer rating is high.
"name[The Eagle], eatType[coffee shop], food[Chinese], priceRange[£20-25], customer rating[high], area[city centre], familyFriendly[yes], near[Burger King]"	The Eagle is a coffee shop providing chinese food in the £20-25 price range. It is located in the city centre. It is near Burger King. Its customer rating is high.
"name[The Eagle], eatType[coffee shop], food[Chinese], priceRange[£20-25], customer rating[high], area[riverside], familyFriendly[no], near[Burger King]"	The Eagle is a coffee shop providing chinese food in the £20-25 price range. It is located in the riverside. It is near Burger King. Its customer rating is high.
"name[The Eagle], eatType[coffee shop], food[Chinese], priceRange[£20-25], customer rating[high], area[riverside], familyFriendly[yes], near[Burger King]"	The Eagle is a coffee shop providing chinese food in the £20-25 price range. It is located in the riverside. It is near Burger King. Its customer rating is high.
"name[The Eagle], eatType[coffee shop], food[Chinese], priceRange[cheap], customer rating[5 out of 5], area[city centre], familyFriendly[no], near[Burger King]"	The Eagle is a cheap chinese coffee shop located in the city centre near Burger King. It has a customer rating of 5 out of 5 and is not family friendly.
"name[The Eagle], eatType[coffee shop], food[Chinese], priceRange[cheap], customer rating[5 out of 5], area[city centre], familyFriendly[yes], near[Burger King]"	The Eagle is a cheap, family friendly chinese coffee shop located in the city centre near Burger King. It has a customer rating of 5 out of 5.
"name[The Eagle], eatType[coffee shop], food[Chinese], priceRange[cheap], customer rating[5 out of 5], area[riverside], familyFriendly[no], near[Burger King]"	The Eagle is a cheap chinese coffee shop in the riverside area near Burger King. It has a customer rating of 5 out of 5 and is not family friendly.
"name[The Eagle], eatType[coffee shop], food[Chinese], priceRange[cheap], customer rating[5 out of 5], area[riverside], familyFriendly[yes], near[Burger King]"	The Eagle is a coffee shop providing chinese food in the cheap price range. It is located in the riverside. It is near Burger King. Its customer rating is 5 out of 5.
"name[The Eagle], eatType[coffee shop], food[Chinese], priceRange[cheap], customer rating[average], area[city centre], familyFriendly[no], near[Burger King]"	The Eagle is a cheap chinese coffee shop located in the city centre near Burger King. It has an average customer rating and is not family friendly.
"name[The Eagle], eatType[coffee shop], food[Chinese], priceRange[cheap], customer rating[average], area[city centre], familyFriendly[yes], near[Burger King]"	The Eagle is a cheap, family friendly chinese coffee shop located in the city centre near Burger King. It has an average customer rating.
"name[The Eagle], eatType[coffee shop], food[Chinese], priceRange[cheap], customer rating[average], area[riverside], familyFriendly[no], near[Burger King]"	The Eagle is a cheap chinese coffee shop in the riverside area near Burger King. It has an average customer rating and is not family friendly.
"name[The Eagle], eatType[coffee shop], food[Chinese], priceRange[cheap], customer rating[average], area[riverside], familyFriendly[yes], near[Burger King]"	The Eagle is a cheap, family friendly chinese coffee shop in the riverside area near Burger King. It has an average customer rating.
"name[The Eagle], eatType[coffee shop], food[Chinese], priceRange[high], customer rating[1 out of 5], area[city centre], familyFriendly[no], near[Burger King]"	The Eagle is a coffee shop providing chinese food in the high price range. It is located in the city centre. It is near Burger King. Its customer rating is 1 out of 5.
"name[The Eagle], eatType[coffee shop], food[Chinese], priceRange[high], customer rating[1 out of 5], area[city centre], familyFriendly[yes], near[Burger King]"	The Eagle is a coffee shop providing chinese food in the high price range. It is located in the city centre. It is near Burger King. Its customer rating is 1 out of 5.
"name[The Eagle], eatType[coffee shop], food[Chinese], priceRange[high], customer rating[1 out of 5], area[riverside], familyFriendly[no], near[Burger King]"	The Eagle is a coffee shop providing chinese food in the high price range. It is located in the riverside. It is near Burger King. Its customer rating is 1 out of 5.
"name[The Eagle], eatType[coffee shop], food[Chinese], priceRange[high], customer rating[1 out of 5], area[riverside], familyFriendly[yes], near[Burger King]"	The Eagle is a coffee shop providing chinese food in the high price range. It is located in the riverside. It is near Burger King. Its customer rating is 1 out of 5.
"name[The Eagle], eatType[coffee shop], food[Chinese], priceRange[high], customer rating[average], area[city centre], familyFriendly[no], near[Burger King]"	The Eagle is a high priced chinese coffee shop located in the city centre near Burger King. It has an average customer rating and is not child friendly.
"name[The Eagle], eatType[coffee shop], food[Chinese], priceRange[high], customer rating[average], area[city centre], familyFriendly[yes], near[Burger King]"	The Eagle is a coffee shop providing chinese food in the high price range. It is located in the city centre. It is near Burger King. Its customer rating is average.
"name[The Eagle], eatType[coffee shop], food[Chinese], priceRange[high], customer rating[average], area[riverside], familyFriendly[no], near[Burger King]"	The Eagle is a high priced chinese coffee shop in the riverside area near Burger King. It has an average customer rating and is not children friendly.
"name[The Eagle], eatType[coffee shop], food[Chinese], priceRange[high], customer rating[average], area[riverside], familyFriendly[yes], near[Burger King]"	The Eagle is a coffee shop providing chinese food in the high price range. It is located in the riverside. It is near Burger King. Its customer rating is average.
"name[The Eagle], eatType[coffee shop], food[Chinese], priceRange[less than £20], customer rating[low], area[city centre], familyFriendly[no], near[Burger King]"	The Eagle is a coffee shop providing chinese food in the less than £20 price range. It is located in the city centre. It is near Burger King. Its customer rating is low.
"name[The Eagle], eatType[coffee shop], food[Chinese], priceRange[less than £20], customer rating[low], area[city centre], familyFriendly[yes], near[Burger King]"	The Eagle is a coffee shop providing chinese food in the less than £20 price range. It is located in the city centre. It is near Burger King. Its customer rating is low.
"name[The Eagle], eatType[coffee shop], food[Chinese], priceRange[less than £20], customer rating[low], area[riverside], familyFriendly[no], near[Burger King]"	The Eagle is a coffee shop providing chinese food in the less than £20 price range. It is located in the riverside. It is near Burger King. Its customer rating is low.
"name[The Eagle], eatType[coffee shop], food[Chinese], priceRange[less than £20], customer rating[low], area[riverside], familyFriendly[yes], near[Burger King]"	The Eagle is a coffee shop providing chinese food in the less than £20 price range. It is located in the riverside. It is near Burger King. Its customer rating is low.
"name[The Eagle], eatType[coffee shop], food[Chinese], priceRange[moderate], customer rating[1 out of 5], area[city centre], familyFriendly[no], near[Burger King]"	The Eagle is a coffee shop providing chinese food in the moderate price range. It is located in the city centre. It is near Burger King. Its customer rating is 1 out of 5.
"name[The Eagle], eatType[coffee shop], food[Chinese], priceRange[moderate], customer rating[1 out of 5], area[city centre], familyFriendly[yes], near[Burger King]"	The Eagle is a coffee shop providing chinese food in the moderate price range. It is located in the city centre. It is near Burger King. Its customer rating is 1 out of 5.
"name[The Eagle], eatType[coffee shop], food[Chinese], priceRange[moderate], customer rating[1 out of 5], area[riverside], familyFriendly[no], near[Burger King]"	The Eagle is a coffee shop providing chinese food in the moderate price range. It is located in the riverside. It is near Burger King. Its customer rating is 1 out of 5.
"name[The Eagle], eatType[coffee shop], food[Chinese], priceRange[moderate], customer rating[1 out of 5], area[riverside], familyFriendly[yes], near[Burger King]"	The Eagle is a coffee shop providing chinese food in the moderate price range. It is located in the riverside. It is near Burger King. Its customer rating is 1 out of 5.
"name[The Eagle], eatType[coffee shop], food[Chinese], priceRange[moderate], customer rating[3 out of 5], area[city centre], familyFriendly[no], near[Burger King]"	The Eagle is a coffee shop providing chinese food in the moderate price range. It is located in the city centre. It is near Burger King. Its customer rating is 3 out of 5.
"name[The Eagle], eatType[coffee shop], food[Chinese], priceRange[moderate], customer rating[3 out of 5], area[city centre], familyFriendly[yes], near[Burger King]"	The Eagle is a coffee shop providing chinese food in the moderate price range. It is located in the city centre. It is near Burger King. Its customer rating is 3 out of 5.
"name[The Eagle], eatType[coffee shop], food[Chinese], priceRange[moderate], customer rating[3 out of 5], area[riverside], familyFriendly[no], near[Burger King]"	The Eagle is a moderately priced chinese coffee shop in the riverside area near Burger King. It has a customer rating of 3 out of 5 and is not kid friendly.
"name[The Eagle], eatType[coffee shop], food[Chinese], priceRange[moderate], customer rating[3 out of 5], area[riverside], familyFriendly[yes], near[Burger King]"	The Eagle is a coffee shop providing chinese food in the moderate price range. It is located in the riverside. It is near Burger King. Its customer rating is 3 out of 5.
"name[The Eagle], eatType[coffee shop], food[Chinese], priceRange[more than £30], customer rating[high], area[city centre], familyFriendly[no], near[Burger King]"	The Eagle is a coffee shop providing chinese food in the more than £30 price range. It is located in the city centre. It is near Burger King. Its customer rating is high.
"name[The Eagle], eatType[coffee shop], food[Chinese], priceRange[more than £30], customer rating[high], area[city centre], familyFriendly[yes], near[Burger King]"	The Eagle is a coffee shop providing chinese food in the more than £30 price range. It is located in the city centre. It is near Burger King. Its customer rating is high.
"name[The Eagle], eatType[coffee shop], food[Chinese], priceRange[more than £30], customer rating[high], area[riverside], familyFriendly[no], near[Burger King]"	The Eagle is a coffee shop providing chinese food in the more than £30 price range. It is located in the riverside. It is near Burger King. Its customer rating is high.
"name[The Eagle], eatType[coffee shop], food[Chinese], priceRange[more than £30], customer rating[high], area[riverside], familyFriendly[yes], near[Burger King]"	The Eagle is a coffee shop providing chinese food in the more than £30 price range. It is located in the riverside. It is near Burger King. Its customer rating is high.
"name[The Eagle], eatType[coffee shop], food[English], priceRange[£20-25], customer rating[high], area[city centre], familyFriendly[no], near[Burger King]"	The Eagle is a coffee shop providing english food in the £20-25 price range. It is located in the city centre. It is near Burger King. Its customer rating is high.
"name[The Eagle], eatType[coffee shop], food[English], priceRange[£20-25], customer rating[high], area[city centre], familyFriendly[yes], near[Burger King]"	The Eagle is a family-friendly coffee shop serving english food in the £20-25 price range. It is located in the city centre near Burger King.
"name[The Eagle], eatType[coffee shop], food[English], priceRange[£20-25], customer rating[high], area[riverside], familyFriendly[no], near[Burger King]"	The Eagle is a coffee shop providing english food in the £20-25 price range. It is located in the riverside area near Burger King. Its customer rating is high.
"name[The Eagle], eatType[coffee shop], food[English], priceRange[£20-25], customer rating[high], area[riverside], familyFriendly[yes], near[Burger King]"	The Eagle is a kid friendly coffee shop serving english food in the riverside area near Burger King. It has a high customer rating and a price range of £20-25.
"name[The Eagle], eatType[coffee shop], food[English], priceRange[cheap], customer rating[5 out of 5], area[city centre], familyFriendly[no], near[Burger King]"	The Eagle is a cheap english coffee shop located in the city centre near Burger King. It has a customer rating of 5 out of 5 and is not family-friendly.
"name[The Eagle], eatType[coffee shop], food[English], priceRange[cheap], customer rating[5 out of 5], area[city centre], familyFriendly[yes], near[Burger King]"	The Eagle is a cheap, family-friendly coffee shop near Burger King in the city centre. It serves english food and has a customer rating of 5 out of 5.
"name[The Eagle], eatType[coffee shop], food[English], priceRange[cheap], customer rating[5 out of 5], area[riverside], familyFriendly[no], near[Burger King]"	The Eagle is a coffee shop providing english food in the cheap price range. It is located in the riverside area. It is near Burger King. Its customer rating is 5 out of 5.
"name[The Eagle], eatType[coffee shop], food[English], priceRange[cheap], customer rating[5 out of 5], area[riverside], familyFriendly[yes], near[Burger King]"	The Eagle is a family friendly coffee shop serving cheap english food near Burger King in the riverside area. It has a customer rating of 5 out of 5.
"name[The Eagle], eatType[coffee shop], food[English], priceRange[cheap], customer rating[average], area[city centre], familyFriendly[no], near[Burger King]"	The Eagle is a cheap english coffee shop near Burger King in the city centre. It has an average customer rating and is not family-friendly.
"name[The Eagle], eatType[coffee shop], food[English], priceRange[cheap], customer rating[average], area[city centre], familyFriendly[yes], near[Burger King]"	The Eagle is a cheap, family-friendly coffee shop near Burger King in the city centre. It serves english food and has an average customer rating.
"name[The Eagle], eatType[coffee shop], food[English], priceRange[cheap], customer rating[average], area[riverside], familyFriendly[no], near[Burger King]"	The Eagle is a cheap english coffee shop near Burger King in the riverside area. It has an average customer rating and is not family-friendly.
"name[The Eagle], eatType[coffee shop], food[English], priceRange[cheap], customer rating[average], area[riverside], familyFriendly[yes], near[Burger King]"	The Eagle is a cheap, family friendly coffee shop near Burger King in the riverside area. It has an average customer rating and serves english food.
"name[The Eagle], eatType[coffee shop], food[English], priceRange[high], customer rating[1 out of 5], area[city centre], familyFriendly[no], near[Burger King]"	The Eagle is a coffee shop providing english food in the high price range. It is located in the city centre. It is near Burger King. Its customer rating is 1 out of 5 and is not child friendly.
"name[The Eagle], eatType[coffee shop], food[English], priceRange[high], customer rating[1 out of 5], area[city centre], familyFriendly[yes], near[Burger King]"	The Eagle is a coffee shop providing english food in the high price range. It is located in the city centre. It is near Burger King. Its customer rating is 1 out of 5.
"name[The Eagle], eatType[coffee shop], food[English], priceRange[high], customer rating[1 out of 5], area[riverside], familyFriendly[no], near[Burger King]"	The Eagle is a coffee shop providing english food in the high price range. It is located in the riverside area. It is near Burger King. Its customer rating is 1 out of 5 and is not children friendly.
"name[The Eagle], eatType[coffee shop], food[English], priceRange[high], customer rating[1 out of 5], area[riverside], familyFriendly[yes], near[Burger King]"	The Eagle is a children friendly coffee shop serving english food in the riverside area near Burger King. It has a high price range and a customer rating of 1 out of 5.
"name[The Eagle], eatType[coffee shop], food[English], priceRange[high], customer rating[average], area[city centre], familyFriendly[no], near[Burger King]"	The Eagle is a coffee shop serving english food in the high price range. It is located in the city centre near Burger King. It has an average customer rating and is not child friendly.
"name[The Eagle], eatType[coffee shop], food[English], priceRange[high], customer rating[average], area[city centre], familyFriendly[yes], near[Burger King]"	The Eagle is an expensive, family-friendly coffee shop near Burger King in the city centre. It serves english food and has an average customer rating.
"name[The Eagle], eatType[coffee shop], food[English], priceRange[high], customer rating[average], area[riverside], familyFriendly[no], near[Burger King]"	The Eagle is a high priced coffee shop that serves english food. It is located in the riverside area near Burger King. It has an average customer rating and is not child friendly.
"name[The Eagle], eatType[coffee shop], food[English], priceRange[high], customer rating[average], area[riverside], familyFriendly[yes], near[Burger King]"	The Eagle is a high priced coffee shop that serves english food. It is located in the riverside area near Burger King. It has an average customer rating and is child friendly.
"name[The Eagle], eatType[coffee shop], food[English], priceRange[less than £20], customer rating[low], area[city centre], familyFriendly[no], near[Burger King]"	The Eagle is a coffee shop providing english food in the less than £20 price range. It is located in the city centre. It is near Burger King. Its customer rating is low.
"name[The Eagle], eatType[coffee shop], food[English], priceRange[less than £20], customer rating[low], area[city centre], familyFriendly[yes], near[Burger King]"	The Eagle is a family-friendly coffee shop that serves english food with a price range of less than £20. It is located in the city centre near Burger King. It has a low customer rating.
"name[The Eagle], eatType[coffee shop], food[English], priceRange[less than £20], customer rating[low], area[riverside], familyFriendly[no], near[Burger King]"	The Eagle is a coffee shop providing english food in the less than £20 price range. It is located in the riverside area. It is near Burger King. Its customer rating is low.
"name[The Eagle], eatType[coffee shop], food[English], priceRange[less than £20], customer rating[low], area[riverside], familyFriendly[yes], near[Burger King]"	The Eagle is a family friendly coffee shop serving english food in the riverside area near Burger King. It has a low customer rating and a price range of less than £20.
"name[The Eagle], eatType[coffee shop], food[English], priceRange[moderate], customer rating[1 out of 5], area[city centre], familyFriendly[no], near[Burger King]"	The Eagle is a moderately priced coffee shop serving english food near Burger King in the city centre. It has a customer rating of 1 out of 5 and is not kid friendly.
"name[The Eagle], eatType[coffee shop], food[English], priceRange[moderate], customer rating[1 out of 5], area[city centre], familyFriendly[yes], near[Burger King]"	The Eagle is a coffee shop providing english food in the moderate price range. It is located in the city centre. It is near Burger King. Its customer rating is 1 out of 5.
"name[The Eagle], eatType[coffee shop], food[English], priceRange[moderate], customer rating[1 out of 5], area[riverside], familyFriendly[no], near[Burger King]"	The Eagle is a coffee shop providing english food in the moderate price range. It is located in the riverside area. It is near Burger King. Its customer rating is 1 out of 5 and is not kid friendly.
"name[The Eagle], eatType[coffee shop], food[English], priceRange[moderate], customer rating[1 out of 5], area[riverside], familyFriendly[yes], near[Burger King]"	The Eagle is a moderately priced coffee shop that serves english food. It is located in the riverside area near Burger King. It is kid friendly and has a customer rating of 1 out of 5.
"name[The Eagle], eatType[coffee shop], food[English], priceRange[moderate], customer rating[3 out of 5], area[city centre], familyFriendly[no], near[Burger King]"	The Eagle is a coffee shop providing english food in the moderate price range. It is located in the city centre. It is near Burger King. It has a customer rating of 3 out of 5 and is not kid friendly.
"name[The Eagle], eatType[coffee shop], food[English], priceRange[moderate], customer rating[3 out of 5], area[city centre], familyFriendly[yes], near[Burger King]"	The Eagle is a family-friendly coffee shop serving english food in the moderate price range. It is located in the city centre near Burger King.
"name[The Eagle], eatType[coffee shop], food[English], priceRange[moderate], customer rating[3 out of 5], area[riverside], familyFriendly[no], near[Burger King]"	The Eagle is a coffee shop providing english food in the moderate price range. It is located in the riverside area. It is near Burger King. Its customer rating is 3 out of 5 and is not kid friendly.
"name[The Eagle], eatType[coffee shop], food[English], priceRange[moderate], customer rating[3 out of 5], area[riverside], familyFriendly[yes], near[Burger King]"	The Eagle is a kid friendly coffee shop serving english food in the moderate price range. It has a customer rating of 3 out of 5. It is located in the riverside area near Burger King.
"name[The Eagle], eatType[coffee shop], food[English], priceRange[more than £30], customer rating[high], area[city centre], familyFriendly[no], near[Burger King]"	The Eagle is a coffee shop providing english food in the more than £30 price range. It is located in the city centre. It is near Burger King. Its customer rating is high.
"name[The Eagle], eatType[coffee shop], food[English], priceRange[more than £30], customer rating[high], area[city centre], familyFriendly[yes], near[Burger King]"	The Eagle is a coffee shop providing english food in the more than £30 price range. It is located in the city centre. It is near Burger King. Its customer rating is high.
"name[The Eagle], eatType[coffee shop], food[English], priceRange[more than £30], customer rating[high], area[riverside], familyFriendly[no], near[Burger King]"	The Eagle is a coffee shop providing english food in the more than £30 price range. It is located in the riverside. It is near Burger King. Its customer rating is high.
"name[The Golden Palace], eatType[coffee shop], food[Chinese], priceRange[£20-25], customer rating[high], area[city centre]"	The Golden Palace is a coffee shop providing chinese food in the £20-25 price range. It is located in the city centre. Its customer rating is high.
"name[The Golden Palace], eatType[coffee shop], food[Chinese], priceRange[£20-25], customer rating[high], area[riverside]"	The Golden Palace is a coffee shop providing chinese food in the £20-25 price range. It is located in the riverside. Its customer rating is high.
"name[The Golden Palace], eatType[coffee shop], food[Chinese], priceRange[cheap], customer rating[5 out of 5], area[city centre]"	The Golden Palace is a coffee shop providing chinese food in the cheap price range. It is located in the city centre. Its customer rating is 5 out of 5.
"name[The Golden Palace], eatType[coffee shop], food[Chinese], priceRange[cheap], customer rating[5 out of 5], area[riverside]"	The Golden Palace is a cheap chinese coffee shop located in the riverside area. It has a customer rating of 5 out of 5.
"name[The Golden Palace], eatType[coffee shop], food[Chinese], priceRange[cheap], customer rating[average], area[city centre]"	The Golden Palace is a cheap chinese coffee shop located in the city centre. It has an average customer rating.
"name[The Golden Palace], eatType[coffee shop], food[Chinese], priceRange[cheap], customer rating[average], area[riverside]"	The Golden Palace is a cheap, average rated chinese coffee shop in the riverside area.
"name[The Golden Palace], eatType[coffee shop], food[Chinese], priceRange[high], customer rating[1 out of 5], area[city centre]"	The Golden Palace is a coffee shop providing chinese food in the high price range. It is located in the city centre. Its customer rating is 1 out of 5.
"name[The Golden Palace], eatType[coffee shop], food[Chinese], priceRange[high], customer rating[1 out of 5], area[riverside]"	The Golden Palace is a coffee shop providing chinese food in the high price range. It is located in the riverside. Its customer rating is 1 out of 5.
"name[The Golden Palace], eatType[coffee shop], food[Chinese], priceRange[high], customer rating[average], area[city centre]"	The Golden Palace is a high priced chinese coffee shop located in the city centre. It has an average customer rating.
"name[The Golden Palace], eatType[coffee shop], food[Chinese], priceRange[high], customer rating[average], area[riverside]"	The Golden Palace is a high priced chinese coffee shop located in the riverside area. It has an average customer rating.
"name[The Golden Palace], eatType[coffee shop], food[Chinese], priceRange[less than £20], customer rating[low], area[city centre]"	The Golden Palace is a coffee shop providing chinese food in the less than £20 price range. It is located in the city centre. Its customer rating is low.
"name[The Golden Palace], eatType[coffee shop], food[Chinese], priceRange[less than £20], customer rating[low], area[riverside]"	The Golden Palace is a coffee shop providing chinese food in the less than £20 price range. It is located in the riverside. Its customer rating is low.
"name[The Golden Palace], eatType[coffee shop], food[Chinese], priceRange[moderate], customer rating[1 out of 5], area[city centre]"	The Golden Palace is a coffee shop providing chinese food in the moderate price range. It is located in the city centre. Its customer rating is 1 out of 5.
"name[The Golden Palace], eatType[coffee shop], food[Chinese], priceRange[moderate], customer rating[1 out of 5], area[riverside]"	The Golden Palace is a coffee shop providing chinese food in the moderate price range. It is located in the riverside. Its customer rating is 1 out of 5.
"name[The Golden Palace], eatType[coffee shop], food[Chinese], priceRange[moderate], customer rating[3 out of 5], area[city centre]"	The Golden Palace is a coffee shop providing chinese food in the moderate price range. It is located in the city centre. Its customer rating is 3 out of 5.
"name[The Golden Palace], eatType[coffee shop], food[Chinese], priceRange[moderate], customer rating[3 out of 5], area[riverside]"	The Golden Palace is a coffee shop providing chinese food in the moderate price range. It is located in the riverside. Its customer rating is 3 out of 5.
"name[The Golden Palace], eatType[coffee shop], food[Chinese], priceRange[more than £30], customer rating[high], area[city centre]"	The Golden Palace is a coffee shop providing chinese food in the more than £30 price range. It is located in the city centre. Its customer rating is high.
"name[The Golden Palace], eatType[coffee shop], food[Chinese], priceRange[more than £30], customer rating[high], area[riverside]"	The Golden Palace is a highly rated, high priced coffee shop that serves chinese food in the riverside area.
"name[The Golden Palace], eatType[coffee shop], food[English], priceRange[£20-25], customer rating[high], area[city centre]"	The Golden Palace is a coffee shop providing english food in the £20-25 price range. It is located in the city centre. Its customer rating is high.
"name[The Golden Palace], eatType[coffee shop], food[English], priceRange[£20-25], customer rating[high], area[riverside]"	The Golden Palace is a highly rated, moderately priced coffee shop that serves english food in the riverside area.
"name[The Golden Palace], eatType[coffee shop], food[English], priceRange[cheap], customer rating[5 out of 5], area[city centre]"	The Golden Palace is a coffee shop providing english food in the cheap price range. It is located in the city centre. Its customer rating is 5 out of 5.
"name[The Golden Palace], eatType[coffee shop], food[English], priceRange[cheap], customer rating[5 out of 5], area[riverside]"	The Golden Palace is a cheap coffee shop serving english food in the riverside area. It has a customer rating of 5 out of 5.
"name[The Golden Palace], eatType[coffee shop], food[English], priceRange[cheap], customer rating[average], area[city centre]"	The Golden Palace is a cheap english coffee shop in the city centre with an average customer rating.
"name[The Golden Palace], eatType[coffee shop], food[English], priceRange[cheap], customer rating[average], area[riverside]"	The Golden Palace is a cheap coffee shop serving english food in the riverside area. It has an average customer rating.
"name[The Golden Palace], eatType[coffee shop], food[English], priceRange[high], customer rating[1 out of 5], area[city centre]"	The Golden Palace is a coffee shop providing english food in the high price range. It is located in the city centre. Its customer rating is 1 out of 5.
"name[The Golden Palace], eatType[coffee shop], food[English], priceRange[high], customer rating[1 out of 5], area[riverside]"	The Golden Palace is a high priced coffee shop serving english food in the riverside area. It has a customer rating of 1 out of 5.
"name[The Golden Palace], eatType[coffee shop], food[English], priceRange[high], customer rating[average], area[city centre]"	The Golden Palace is a high priced coffee shop serving english food in the city centre. It has an average customer rating.
"name[The Golden Palace], eatType[coffee shop], food[English], priceRange[high], customer rating[average], area[riverside]"	The Golden Palace is a high priced coffee shop serving english food in the riverside area. It has an average customer rating.
"name[The Golden Palace], eatType[coffee shop], food[English], priceRange[less than £20], customer rating[low], area[city centre]"	The Golden Palace is a coffee shop providing english food in the less than £20 price range. It is located in the city centre. Its customer rating is low.
"name[The Golden Palace], eatType[coffee shop], food[English], priceRange[less than £20], customer rating[low], area[riverside]"	The Golden Palace is a low-priced coffee shop that serves english food. It is located in the riverside area and has a low customer rating.
"name[The Golden Palace], eatType[coffee shop], food[English], priceRange[moderate], customer rating[1 out of 5], area[city centre]"	The Golden Palace is a coffee shop providing english food in the moderate price range. It is located in the city centre. Its customer rating is 1 out of 5.
"name[The Golden Palace], eatType[coffee shop], food[English], priceRange[moderate], customer rating[1 out of 5], area[riverside]"	The Golden Palace is a moderately priced coffee shop with a customer rating of 1 out of 5.
"name[The Golden Palace], eatType[coffee shop], food[English], priceRange[moderate], customer rating[3 out of 5], area[city centre]"	The Golden Palace is a coffee shop providing english food in the moderate price range. It is located in the city centre. Its customer rating is 3 out of 5.
"name[The Golden Palace], eatType[coffee shop], food[English], priceRange[moderate], customer rating[3 out of 5], area[riverside]"	The Golden Palace is a moderately priced coffee shop serving english food in the riverside area. It has a customer rating of 3 out of 5.
"name[The Golden Palace], eatType[coffee shop], food[English], priceRange[more than £30], customer rating[high], area[city centre]"	The Golden Palace is a coffee shop providing english food in the more than £30 price range. It is located in the city centre. Its customer rating is high.
"name[The Golden Palace], eatType[coffee shop], food[English], priceRange[more than £30], customer rating[high], area[riverside]"	The Golden Palace is a high priced coffee shop that serves english food. It is located in the riverside area and has a high customer rating.
"name[The Mill], eatType[coffee shop], food[Chinese], priceRange[£20-25], area[riverside], near[The Sorrento]"	The Mill is a moderately priced coffee shop that serves chinese food in the riverside area near The Sorrento.
"name[The Mill], eatType[coffee shop], food[Chinese], priceRange[cheap], area[riverside], near[The Sorrento]"	The Mill is a cheap chinese coffee shop in the riverside area near The Sorrento.
"name[The Mill], eatType[coffee shop], food[Chinese], priceRange[high], area[city centre], near[The Sorrento]"	The Mill is a high priced coffee shop that serves chinese food in the city centre near The Sorrento.
"name[The Mill], eatType[coffee shop], food[Chinese], priceRange[high], area[riverside], near[The Sorrento]"	The Mill is a high priced coffee shop that serves chinese food in the riverside area near The Sorrento.
"name[The Mill], eatType[coffee shop], food[Chinese], priceRange[less than £20], area[city centre], near[The Sorrento]"	The Mill is a coffee shop providing chinese food in the less than £20 price range. It is located in the city centre. It is near The Sorrento.
"name[The Mill], eatType[coffee shop], food[Chinese], priceRange[less than £20], area[riverside], near[The Sorrento]"	The Mill is a coffee shop providing chinese food in the less than £20 price range. It is located in the riverside. It is near The Sorrento.
"name[The Mill], eatType[coffee shop], food[Chinese], priceRange[moderate], area[city centre], near[The Sorrento]"	The Mill is a moderately priced coffee shop serving chinese food in the city centre near The Sorrento.
"name[The Mill], eatType[coffee shop], food[Chinese], priceRange[moderate], area[riverside], near[The Sorrento]"	The Mill is a moderately priced coffee shop that serves chinese food in the riverside area near The Sorrento.
"name[The Mill], eatType[coffee shop], food[Chinese], priceRange[more than £30], area[riverside], near[The Sorrento]"	The Mill is a coffee shop that serves expensive chinese food in the riverside area near The Sorrento.
"name[The Mill], eatType[coffee shop], food[English], priceRange[£20-25], area[riverside], near[The Sorrento]"	The Mill is a coffee shop providing english food in the £20-25 price range. It is located in the riverside area near The Sorrento.
"name[The Mill], eatType[coffee shop], food[English], priceRange[cheap], area[riverside], near[The Sorrento]"	The Mill is a cheap coffee shop serving english food near The Sorrento in the riverside area.
"name[The Mill], eatType[coffee shop], food[English], priceRange[high], area[city centre], near[The Sorrento]"	The Mill is a coffee shop providing english food in the high price range. It is located in the city centre near The Sorrento.
"name[The Mill], eatType[coffee shop], food[English], priceRange[high], area[riverside], near[The Sorrento]"	The Mill is a high priced coffee shop located near The Sorrento.
"name[The Mill], eatType[coffee shop], food[English], priceRange[less than £20], area[city centre], near[The Sorrento]"	The Mill is a coffee shop providing english food in the less than £20 price range. It is located in the city centre near The Sorrento.
"name[The Mill], eatType[coffee shop], food[English], priceRange[less than £20], area[riverside], near[The Sorrento]"	The Mill is a cheap coffee shop located near The Sorrento.
"name[The Mill], eatType[coffee shop], food[English], priceRange[moderate], area[city centre], near[The Sorrento]"	The Mill is a moderately priced coffee shop serving english food in the city centre near The Sorrento.
"name[The Mill], eatType[coffee shop], food[English], priceRange[moderate], area[riverside], near[The Sorrento]"	The Mill is a moderately priced coffee shop located near The Sorrento.
"name[The Mill], eatType[coffee shop], food[English], priceRange[more than £30], area[riverside], near[The Sorrento]"	The Mill is a coffee shop that serves english food with a price range of more than £30. It is located in the riverside area near The Sorrento.
"name[The Phoenix], customer rating[1 out of 5], area[riverside]"	The Phoenix has a customer rating of 1 out of 5 and is in the riverside area.
"name[The Phoenix], customer rating[3 out of 5], area[riverside]"	The Phoenix in riverside has a customer rating of 3 out of 5.
"name[The Phoenix], customer rating[5 out of 5], area[city centre]"	The Phoenix in the city centre has a customer rating of 5 out of 5.
"name[The Phoenix], customer rating[5 out of 5], area[riverside]"	The Phoenix in the riverside area has a 5 out of 5 customer rating.
"name[The Phoenix], customer rating[average], area[city centre]"	The Phoenix in the city centre has an average customer rating.
"name[The Phoenix], customer rating[average], area[riverside]"	The Phoenix in riverside has an average customer rating.
"name[The Phoenix], customer rating[high], area[riverside]"	The Phoenix has a high customer rating in the riverside area.
"name[The Phoenix], customer rating[low], area[city centre]"	The Phoenix in the city centre has a low customer rating.
"name[The Phoenix], customer rating[low], area[riverside]"	The Phoenix is in the riverside area and has a low customer rating.
"name[The Punter], customer rating[1 out of 5], area[riverside], familyFriendly[yes]"	The Punter is a kid friendly restaurant in the riverside area with a customer rating of 1 out of 5.
"name[The Punter], customer rating[3 out of 5], area[riverside], familyFriendly[yes]"	The Punter is a kid friendly restaurant in the riverside area with a customer rating of 3 out of 5.
"name[The Punter], customer rating[5 out of 5], area[city centre], familyFriendly[no]"	The Punter is a 5 out of 5 rated restaurant located in the city centre. It is not family-friendly.
"name[The Punter], customer rating[5 out of 5], area[city centre], familyFriendly[yes]"	The Punter is a family-friendly restaurant in the city centre with a 5 out of 5 customer rating.
"name[The Punter], customer rating[5 out of 5], area[riverside], familyFriendly[no]"	The Punter is located in the riverside area. It is not family-friendly and has a customer rating of 5 out of 5.
"name[The Punter], customer rating[5 out of 5], area[riverside], familyFriendly[yes]"	The Punter is a family friendly restaurant in the riverside area with a 5 out of 5 customer rating.
"name[The Punter], customer rating[average], area[city centre], familyFriendly[no]"	The Punter in the city centre has an average customer rating and is not family-friendly.
"name[The Punter], customer rating[average], area[city centre], familyFriendly[yes]"	The Punter is a family-friendly restaurant in the city centre with an average customer rating.
"name[The Punter], customer rating[average], area[riverside], familyFriendly[no]"	The Punter is located in the riverside area. It has an average customer rating and is not family-friendly.
"name[The Punter], customer rating[average], area[riverside], familyFriendly[yes]"	The Punter is a family friendly restaurant in the riverside area with an average customer rating.
"name[The Punter], customer rating[high], area[riverside], familyFriendly[yes]"	The Punter is a child friendly restaurant in the riverside area with a high customer rating.
"name[The Punter], customer rating[low], area[city centre], familyFriendly[no]"	The Punter in the city centre has a low customer rating and is not family-friendly.
"name[The Punter], customer rating[low], area[city centre], familyFriendly[yes]"	The Punter is a family-friendly restaurant in the city centre with a low customer rating.
"name[The Punter], customer rating[low], area[riverside], familyFriendly[no]"	The Punter is located in the riverside area. It has a low customer rating and is not family-friendly.
"name[The Punter], customer rating[low], area[riverside], familyFriendly[yes]"	The Punter is a family friendly restaurant in the riverside area with a low customer rating.
"name[The Punter], eatType[coffee shop], food[Chinese], priceRange[£20-25], customer rating[high], familyFriendly[no], near[Café Sicilia]"	The Punter is a chinese coffee shop with a price range of £20-25. It has a high customer rating and is not kid friendly. It is located near Café Sicilia.
"name[The Punter], eatType[coffee shop], food[Chinese], priceRange[£20-25], customer rating[high], familyFriendly[yes], near[Café Sicilia]"	The Punter is a coffee shop providing chinese food in the £20-25 price range. It is near Café Sicilia. Its customer rating is high.
"name[The Punter], eatType[coffee shop], food[Chinese], priceRange[cheap], customer rating[5 out of 5], familyFriendly[no], near[Café Sicilia]"	The Punter is a cheap chinese coffee shop near Café Sicilia. It has a customer rating of 5 out of 5 and is not family friendly.
"name[The Punter], eatType[coffee shop], food[Chinese], priceRange[cheap], customer rating[5 out of 5], familyFriendly[yes], near[Café Sicilia]"	The Punter is a family friendly coffee shop serving cheap chinese food near Café Sicilia. It has a customer rating of 5 out of 5.
"name[The Punter], eatType[coffee shop], food[Chinese], priceRange[cheap], customer rating[average], familyFriendly[no], near[Café Sicilia]"	The Punter is a cheap chinese coffee shop near Café Sicilia. It has an average customer rating and is not family friendly.
"name[The Punter], eatType[coffee shop], food[Chinese], priceRange[cheap], customer rating[average], familyFriendly[yes], near[Café Sicilia]"	The Punter is a cheap, family friendly coffee shop serving chinese food near Café Sicilia. It has an average customer rating.
"name[The Punter], eatType[coffee shop], food[Chinese], priceRange[high], customer rating[1 out of 5], familyFriendly[no], near[Café Sicilia]"	The Punter is a high priced chinese coffee shop located near Café Sicilia. It is not child friendly and has a customer rating of 1 out of 5.
"name[The Punter], eatType[coffee shop], food[Chinese], priceRange[high], customer rating[1 out of 5], familyFriendly[yes], near[Café Sicilia]"	The Punter is a coffee shop providing chinese food in the high price range. It is near Café Sicilia. Its customer rating is 1 out of 5.
"name[The Punter], eatType[coffee shop], food[Chinese], priceRange[high], customer rating[average], familyFriendly[no], near[Café Sicilia]"	The Punter is a high priced chinese coffee shop near Café Sicilia. It has an average customer rating and is not child friendly.
"name[The Punter], eatType[coffee shop], food[Chinese], priceRange[high], customer rating[average], familyFriendly[yes], near[Café Sicilia]"	The Punter is a coffee shop providing chinese food in the high price range. It is near Café Sicilia. Its customer rating is average.
"name[The Punter], eatType[coffee shop], food[Chinese], priceRange[less than £20], customer rating[low], familyFriendly[no], near[Café Sicilia]"	The Punter is a low-priced chinese coffee shop located near Café Sicilia. It has a low customer rating and is not family friendly.
"name[The Punter], eatType[coffee shop], food[Chinese], priceRange[less than £20], customer rating[low], familyFriendly[yes], near[Café Sicilia]"	The Punter is a family friendly coffee shop that serves chinese food for less than £20. It has a low customer rating and is located near Café Sicilia.
"name[The Punter], eatType[coffee shop], food[Chinese], priceRange[moderate], customer rating[1 out of 5], familyFriendly[no], near[Café Sicilia]"	The Punter is a moderately priced chinese coffee shop near Café Sicilia. It has a customer rating of 1 out of 5 and is not kid friendly.
"name[The Punter], eatType[coffee shop], food[Chinese], priceRange[moderate], customer rating[1 out of 5], familyFriendly[yes], near[Café Sicilia]"	The Punter is a coffee shop providing chinese food in the moderate price range. It is near Café Sicilia. Its customer rating is 1 out of 5.
"name[The Punter], eatType[coffee shop], food[Chinese], priceRange[moderate], customer rating[3 out of 5], familyFriendly[no], near[Café Sicilia]"	The Punter is a moderately priced chinese coffee shop near Café Sicilia. It has a customer rating of 3 out of 5 and is not kid friendly.
"name[The Punter], eatType[coffee shop], food[Chinese], priceRange[moderate], customer rating[3 out of 5], familyFriendly[yes], near[Café Sicilia]"	The Punter is a kid friendly coffee shop that serves moderately priced chinese food. It has a customer rating of 3 out of 5 and is located near Café Sicilia.
"name[The Punter], eatType[coffee shop], food[Chinese], priceRange[more than £30], customer rating[high], familyFriendly[no], near[Café Sicilia]"	The Punter is a chinese coffee shop near Café Sicilia. It has a high customer rating and a price range of more than £30. It is not children friendly.
"name[The Punter], eatType[coffee shop], food[Chinese], priceRange[more than £30], customer rating[high], familyFriendly[yes], near[Café Sicilia]"	The Punter is a coffee shop providing chinese food in the more than £30 price range. It is near Café Sicilia. Its customer rating is high.
"name[The Punter], eatType[coffee shop], food[English], priceRange[£20-25], customer rating[high], familyFriendly[no], near[Café Sicilia]"	The Punter is a coffee shop near Café Sicilia that serves english food with a price range of £20-25. It has a high customer rating and is not kid friendly.
"name[The Punter], eatType[coffee shop], food[English], priceRange[£20-25], customer rating[high], familyFriendly[yes], near[Café Sicilia]"	The Punter is a kid friendly coffee shop serving english food near Café Sicilia. It has a high customer rating and a price range of £20-25.
"name[The Punter], eatType[coffee shop], food[English], priceRange[cheap], customer rating[5 out of 5], familyFriendly[no], near[Café Sicilia]"	The Punter is a cheap english coffee shop near Café Sicilia. It has a customer rating of 5 out of 5 and is not family-friendly.
"name[The Punter], eatType[coffee shop], food[English], priceRange[cheap], customer rating[5 out of 5], familyFriendly[yes], near[Café Sicilia]"	The Punter is a family friendly coffee shop serving cheap english food near Café Sicilia with a customer rating of 5 out of 5.
"name[The Punter], eatType[coffee shop], food[English], priceRange[cheap], customer rating[average], familyFriendly[no], near[Café Sicilia]"	The Punter is a cheap english coffee shop near Café Sicilia. It has an average customer rating and is not family-friendly.
"name[The Punter], eatType[coffee shop], food[English], priceRange[cheap], customer rating[average], familyFriendly[yes], near[Café Sicilia]"	The Punter is a cheap, family friendly coffee shop near Café Sicilia. It has an average customer rating.
"name[The Punter], eatType[coffee shop], food[English], priceRange[high], customer rating[1 out of 5], familyFriendly[no], near[Café Sicilia]"	The Punter is a high priced coffee shop serving english food near Café Sicilia. It has a customer rating of 1 out of 5 and is not child friendly.
"name[The Punter], eatType[coffee shop], food[English], priceRange[high], customer rating[1 out of 5], familyFriendly[yes], near[Café Sicilia]"	The Punter is a children friendly coffee shop near Café Sicilia that serves english food. It has a high price range and a customer rating of 1 out of 5.
"name[The Punter], eatType[coffee shop], food[English], priceRange[high], customer rating[average], familyFriendly[no], near[Café Sicilia]"	The Punter is a high priced coffee shop serving english food near Café Sicilia. It has an average customer rating and is not child friendly.
"name[The Punter], eatType[coffee shop], food[English], priceRange[high], customer rating[average], familyFriendly[yes], near[Café Sicilia]"	The Punter is an expensive, family friendly coffee shop near Café Sicilia that serves english food. It has an average customer rating.
"name[The Punter], eatType[coffee shop], food[English], priceRange[less than £20], customer rating[low], familyFriendly[no], near[Café Sicilia]"	The Punter is a coffee shop providing english food in the less than £20 price range. It is located near Café Sicilia. It is not family-friendly and has a low customer rating.
"name[The Punter], eatType[coffee shop], food[English], priceRange[less than £20], customer rating[low], familyFriendly[yes], near[Café Sicilia]"	The Punter is a family friendly coffee shop serving english food near Café Sicilia. It has a low customer rating and a price range of less than £20.
"name[The Punter], eatType[coffee shop], food[English], priceRange[moderate], customer rating[1 out of 5], familyFriendly[no], near[Café Sicilia]"	The Punter is a moderately priced coffee shop serving english food near Café Sicilia. It has a customer rating of 1 out of 5 and is not kid friendly.
"name[The Punter], eatType[coffee shop], food[English], priceRange[moderate], customer rating[1 out of 5], familyFriendly[yes], near[Café Sicilia]"	The Punter is a moderately priced coffee shop near Café Sicilia that serves english food. It is kid friendly and has a customer rating of 1 out of 5.
"name[The Punter], eatType[coffee shop], food[English], priceRange[moderate], customer rating[3 out of 5], familyFriendly[no], near[Café Sicilia]"	The Punter is a moderately priced coffee shop serving english food near Café Sicilia. It has a customer rating of 3 out of 5 and is not kid friendly.
"name[The Punter], eatType[coffee shop], food[English], priceRange[moderate], customer rating[3 out of 5], familyFriendly[yes], near[Café Sicilia]"	The Punter is a moderately priced coffee shop near Café Sicilia that serves english food. It is kid friendly and has a customer rating of 3 out of 5.
"name[The Wrestlers], customer rating[1 out of 5], familyFriendly[yes]"	The Wrestlers has a customer rating of 1 out of 5 and is kid friendly.
"name[The Wrestlers], customer rating[1 out of 5], familyFriendly[yes], near[The Sorrento]"	The Wrestlers is a kid friendly restaurant near The Sorrento with a customer rating of 1 out of 5.
"name[The Wrestlers], customer rating[3 out of 5], familyFriendly[yes]"	The Wrestlers has a customer rating of 3 out of 5 and is kid friendly.
"name[The Wrestlers], customer rating[3 out of 5], familyFriendly[yes], near[The Sorrento]"	The Wrestlers is a kid friendly restaurant near The Sorrento with a customer rating of 3 out of 5.
"name[The Wrestlers], customer rating[5 out of 5], familyFriendly[no]"	The Wrestlers has a 5 out of 5 customer rating and is not family-friendly.
"name[The Wrestlers], customer rating[5 out of 5], familyFriendly[no], near[The Sorrento]"	The Wrestlers is located near The Sorrento. It has a customer rating of 5 out of 5 and is not family-friendly.
"name[The Wrestlers], customer rating[5 out of 5], familyFriendly[yes]"	The Wrestlers has a 5 out of 5 customer rating and is family friendly.
"name[The Wrestlers], customer rating[5 out of 5], familyFriendly[yes], near[The Sorrento]"	The Wrestlers is a family friendly restaurant near The Sorrento with a 5 out of 5 customer rating.
"name[The Wrestlers], customer rating[average], familyFriendly[no]"	The Wrestlers is not family-friendly and has an average customer rating.
"name[The Wrestlers], customer rating[average], familyFriendly[no], near[The Sorrento]"	The Wrestlers is near The Sorrento. It is not family-friendly and has an average customer rating.
"name[The Wrestlers], customer rating[average], familyFriendly[yes]"	The Wrestlers is a family friendly place with an average customer rating.
"name[The Wrestlers], customer rating[average], familyFriendly[yes], near[The Sorrento]"	The Wrestlers is a family friendly place near The Sorrento with an average customer rating.
"name[The Wrestlers], customer rating[high], familyFriendly[yes]"	The Wrestlers has a high customer rating and is child friendly.
"name[The Wrestlers], customer rating[high], familyFriendly[yes], near[The Sorrento]"	The Wrestlers is a highly rated, child friendly restaurant near The Sorrento.
"name[The Wrestlers], customer rating[low], familyFriendly[no]"	The Wrestlers is not family-friendly and has a low customer rating.
"name[The Wrestlers], customer rating[low], familyFriendly[no], near[The Sorrento]"	The Wrestlers is near The Sorrento. It has a low customer rating and is not family-friendly.
"name[The Wrestlers], customer rating[low], familyFriendly[yes]"	The Wrestlers is a family friendly restaurant with a low customer rating.
"name[The Wrestlers], customer rating[low], familyFriendly[yes], near[The Sorrento]"	The Wrestlers is a family friendly restaurant near The Sorrento with a low customer rating.
"name[The Wrestlers], eatType[coffee shop], food[Chinese], priceRange[£20-25], area[riverside], familyFriendly[yes], near[Raja Indian Cuisine]"	The Wrestlers is a kid friendly coffee shop serving chinese food in the £20-25 price range. It is located in the riverside area near Raja Indian Cuisine.
"name[The Wrestlers], eatType[coffee shop], food[Chinese], priceRange[cheap], area[riverside], familyFriendly[yes], near[Raja Indian Cuisine]"	The Wrestlers is a cheap, family friendly chinese coffee shop in the riverside area near Raja Indian Cuisine.
"name[The Wrestlers], eatType[coffee shop], food[Chinese], priceRange[high], area[city centre], familyFriendly[no], near[Raja Indian Cuisine]"	The Wrestlers is a high priced chinese coffee shop located in the city centre near Raja Indian Cuisine. It is not children friendly.
"name[The Wrestlers], eatType[coffee shop], food[Chinese], priceRange[high], area[city centre], familyFriendly[yes], near[Raja Indian Cuisine]"	The Wrestlers is a children friendly coffee shop serving high priced chinese food in the city centre near Raja Indian Cuisine.
"name[The Wrestlers], eatType[coffee shop], food[Chinese], priceRange[high], area[riverside], familyFriendly[no], near[Raja Indian Cuisine]"	The Wrestlers is a high priced chinese coffee shop in the riverside area near Raja Indian Cuisine. It is not children friendly.
"name[The Wrestlers], eatType[coffee shop], food[Chinese], priceRange[high], area[riverside], familyFriendly[yes], near[Raja Indian Cuisine]"	The Wrestlers is a children friendly coffee shop serving chinese food in the high price range. It is located in the riverside area near Raja Indian Cuisine.
"name[The Wrestlers], eatType[coffee shop], food[Chinese], priceRange[less than £20], area[city centre], familyFriendly[no], near[Raja Indian Cuisine]"	The Wrestlers is a coffee shop providing chinese food in the less than £20 price range. It is located in the city centre. It is near Raja Indian Cuisine. Its no children feel allowed.
"name[The Wrestlers], eatType[coffee shop], food[Chinese], priceRange[less than £20], area[city centre], familyFriendly[yes], near[Raja Indian Cuisine]"	The Wrestlers is a family friendly coffee shop serving chinese food in the less than £20 price range. It is located in the city centre near Raja Indian Cuisine.
"name[The Wrestlers], eatType[coffee shop], food[Chinese], priceRange[less than £20], area[riverside], familyFriendly[no], near[Raja Indian Cuisine]"	The Wrestlers is a coffee shop providing chinese food in the less than £20 price range. It is located in the riverside. It is near Raja Indian Cuisine. Its no children feel allowed.
"name[The Wrestlers], eatType[coffee shop], food[Chinese], priceRange[less than £20], area[riverside], familyFriendly[yes], near[Raja Indian Cuisine]"	The Wrestlers is a family friendly coffee shop serving chinese food in the less than £20 price range. It is located in the riverside area near Raja Indian Cuisine.
"name[The Wrestlers], eatType[coffee shop], food[Chinese], priceRange[moderate], area[city centre], familyFriendly[no], near[Raja Indian Cuisine]"	The Wrestlers is a moderately priced chinese coffee shop located in the city centre near Raja Indian Cuisine. It is not kid friendly.
"name[The Wrestlers], eatType[coffee shop], food[Chinese], priceRange[moderate], area[city centre], familyFriendly[yes], near[Raja Indian Cuisine]"	The Wrestlers is a moderately priced, kid friendly chinese coffee shop located in the city centre near Raja Indian Cuisine.
"name[The Wrestlers], eatType[coffee shop], food[Chinese], priceRange[moderate], area[riverside], familyFriendly[no], near[Raja Indian Cuisine]"	The Wrestlers is a moderately priced chinese coffee shop in the riverside area near Raja Indian Cuisine. It is not kid friendly.
"name[The Wrestlers], eatType[coffee shop], food[Chinese], priceRange[moderate], area[riverside], familyFriendly[yes], near[Raja Indian Cuisine]"	The Wrestlers is a kid friendly coffee shop that serves moderately priced chinese food in the riverside area near Raja Indian Cuisine.
"name[The Wrestlers], eatType[coffee shop], food[Chinese], priceRange[more than £30], area[riverside], familyFriendly[yes], near[Raja Indian Cuisine]"	The Wrestlers is a coffee shop providing chinese food in the more than £30 price range. It is located in the riverside. It is near Raja Indian Cuisine.
"name[The Wrestlers], eatType[coffee shop], food[English], priceRange[£20-25], area[riverside], familyFriendly[yes], near[Raja Indian Cuisine]"	The Wrestlers is a kid friendly coffee shop serving english food in the £20-25 price range. It is located in the riverside area near Raja Indian Cuisine.
"name[The Wrestlers], eatType[coffee shop], food[English], priceRange[cheap], area[riverside], familyFriendly[yes], near[Raja Indian Cuisine]"	The Wrestlers is a cheap family friendly coffee shop serving english food in the riverside area near Raja Indian Cuisine.
"name[The Wrestlers], eatType[coffee shop], food[English], priceRange[high], area[city centre], familyFriendly[no], near[Raja Indian Cuisine]"	The Wrestlers is a coffee shop serving english food in the high price range. It is located in the city centre near Raja Indian Cuisine. It is not child friendly.
"name[The Wrestlers], eatType[coffee shop], food[English], priceRange[high], area[city centre], familyFriendly[yes], near[Raja Indian Cuisine]"	The Wrestlers is a children friendly coffee shop serving english food in the high price range. It is located in the city centre near Raja Indian Cuisine.
"name[The Wrestlers], eatType[coffee shop], food[English], priceRange[high], area[riverside], familyFriendly[no], near[Raja Indian Cuisine]"	The Wrestlers is a coffee shop providing english food in the high price range. It is located in the riverside area near Raja Indian Cuisine.
"name[The Wrestlers], eatType[coffee shop], food[English], priceRange[high], area[riverside], familyFriendly[yes], near[Raja Indian Cuisine]"	The Wrestlers is a children friendly coffee shop serving english food in the high price range. It is located in the riverside area near Raja Indian Cuisine.
"name[The Wrestlers], eatType[coffee shop], food[English], priceRange[less than £20], area[city centre], familyFriendly[no], near[Raja Indian Cuisine]"	The Wrestlers is a coffee shop providing english food in the less than £20 price range. It is located in the city centre. It is not family-friendly. It is located near Raja Indian Cuisine.
"name[The Wrestlers], eatType[coffee shop], food[English], priceRange[less than £20], area[city centre], familyFriendly[yes], near[Raja Indian Cuisine]"	The Wrestlers is a family-friendly coffee shop serving english food in the price range of less than £20. It is located in the city centre near Raja Indian Cuisine.
"name[The Wrestlers], eatType[coffee shop], food[English], priceRange[less than £20], area[riverside], familyFriendly[no], near[Raja Indian Cuisine]"	The Wrestlers is a coffee shop providing english food in the less than £20 price range. It is located in the riverside area near Raja Indian Cuisine.
"name[The Wrestlers], eatType[coffee shop], food[English], priceRange[less than £20], area[riverside], familyFriendly[yes], near[Raja Indian Cuisine]"	The Wrestlers is a family friendly coffee shop located near Raja Indian Cuisine.
"name[The Wrestlers], eatType[coffee shop], food[English], priceRange[moderate], area[city centre], familyFriendly[no], near[Raja Indian Cuisine]"	The Wrestlers is a moderately priced english coffee shop near Raja Indian Cuisine in the city centre. It is not kid friendly.
"name[The Wrestlers], eatType[coffee shop], food[English], priceRange[moderate], area[city centre], familyFriendly[yes], near[Raja Indian Cuisine]"	The Wrestlers is a kid friendly coffee shop serving english food in the moderate price range. It is located in the city centre near Raja Indian Cuisine.
"name[The Wrestlers], eatType[coffee shop], food[English], priceRange[moderate], area[riverside], familyFriendly[no], near[Raja Indian Cuisine]"	The Wrestlers is a moderately priced english coffee shop near Raja Indian Cuisine in the riverside area. It is not kid friendly.
"name[The Wrestlers], eatType[coffee shop], food[English], priceRange[moderate], area[riverside], familyFriendly[yes], near[Raja Indian Cuisine]"	The Wrestlers is a moderately priced family friendly coffee shop located near Raja Indian Cuisine.
"name[The Wrestlers], eatType[coffee shop], food[English], priceRange[more than £30], area[riverside], familyFriendly[yes], near[Raja Indian Cuisine]"	The Wrestlers is a children friendly coffee shop serving english food in the riverside area near Raja Indian Cuisine. The price range is more than £30.
"name[Travellers Rest Beefeater], customer rating[1 out of 5], area[riverside], near[Raja Indian Cuisine]"	Travellers Rest Beefeater has a customer rating of 1 out of 5 and is located in the riverside area near Raja Indian Cuisine.
"name[Travellers Rest Beefeater], customer rating[3 out of 5], area[riverside], near[Raja Indian Cuisine]"	Travellers Rest Beefeater is located in the riverside area near Raja Indian Cuisine. It has a customer rating of 3 out of 5.
"name[Travellers Rest Beefeater], customer rating[5 out of 5], area[city centre], near[Raja Indian Cuisine]"	Travellers Rest Beefeater has a customer rating of 5 out of 5 and is located in the city centre near Raja Indian Cuisine.
"name[Travellers Rest Beefeater], customer rating[5 out of 5], area[riverside], near[Raja Indian Cuisine]"	Travellers Rest Beefeater has a 5 out of 5 customer rating and is in the riverside area near Raja Indian Cuisine.
"name[Travellers Rest Beefeater], customer rating[average], area[city centre], near[Raja Indian Cuisine]"	Travellers Rest Beefeater is located in the city centre near Raja Indian Cuisine. It has an average customer rating.
"name[Travellers Rest Beefeater], customer rating[average], area[riverside], near[Raja Indian Cuisine]"	Near Raja Indian Cuisine in the riverside area, Travellers Rest Beefeater has an average customer rating.
"name[Travellers Rest Beefeater], customer rating[high], area[riverside], near[Raja Indian Cuisine]"	Near Raja Indian Cuisine in the riverside area is a highly rated place called Travellers Rest Beefeater.
"name[Travellers Rest Beefeater], customer rating[low], area[city centre], near[Raja Indian Cuisine]"	Travellers Rest Beefeater is located in the city centre near Raja Indian Cuisine and has a low customer rating.
"name[Travellers Rest Beefeater], customer rating[low], area[riverside], near[Raja Indian Cuisine]"	Travellers Rest Beefeater has a low customer rating and is located in the riverside area near Raja Indian Cuisine.
"name[Wildwood], eatType[coffee shop], food[Chinese], priceRange[£20-25], customer rating[high], near[Ranch]"	Wildwood is a coffee shop providing chinese food in the £20-25 price range. It is near Ranch. Its customer rating is high.
"name[Wildwood], eatType[coffee shop], food[Chinese], priceRange[cheap], customer rating[5 out of 5], near[Ranch]"	Wildwood is a cheap coffee shop serving chinese food near Ranch. It has a customer rating of 5 out of 5.
"name[Wildwood], eatType[coffee shop], food[Chinese], priceRange[cheap], customer rating[average], near[Ranch]"	Wildwood is a cheap chinese coffee shop near Ranch. It has an average customer rating.
"name[Wildwood], eatType[coffee shop], food[Chinese], priceRange[high], customer rating[1 out of 5], near[Ranch]"	Wildwood is a coffee shop providing chinese food in the high price range. It is near Ranch. Its customer rating is 1 out of 5.
"name[Wildwood], eatType[coffee shop], food[Chinese], priceRange[high], customer rating[average], near[Ranch]"	Wildwood is a chinese coffee shop located near Ranch. It has a high price range and an average customer rating.
"name[Wildwood], eatType[coffee shop], food[Chinese], priceRange[less than £20], customer rating[low], near[Ranch]"	Wildwood is a coffee shop providing chinese food in the less than £20 price range. It is near Ranch. Its customer rating is low.
"name[Wildwood], eatType[coffee shop], food[Chinese], priceRange[moderate], customer rating[1 out of 5], near[Ranch]"	Wildwood is a coffee shop providing chinese food in the moderate price range. It is near Ranch. Its customer rating is 1 out of 5.
"name[Wildwood], eatType[coffee shop], food[Chinese], priceRange[moderate], customer rating[3 out of 5], near[Ranch]"	Wildwood is a coffee shop providing chinese food in the moderate price range. It is near Ranch. Its customer rating is 3 out of 5.
"name[Wildwood], eatType[coffee shop], food[Chinese], priceRange[more than £30], customer rating[high], near[Ranch]"	Wildwood is a coffee shop providing chinese food in the more than £30 price range. It is near Ranch. Its customer rating is high.
"name[Wildwood], eatType[coffee shop], food[English], priceRange[£20-25], customer rating[high], near[Ranch]"	Wildwood is a coffee shop providing english food in the £20-25 price range. It is near Ranch. Its customer rating is high.
"name[Wildwood], eatType[coffee shop], food[English], priceRange[cheap], customer rating[5 out of 5], near[Ranch]"	Wildwood is a cheap coffee shop serving english food near Ranch. It has a customer rating of 5 out of 5.
"name[Wildwood], eatType[coffee shop], food[English], priceRange[cheap], customer rating[average], near[Ranch]"	Wildwood is a cheap coffee shop serving english food near Ranch. It has an average customer rating.
"name[Wildwood], eatType[coffee shop], food[English], priceRange[high], customer rating[1 out of 5], near[Ranch]"	Wildwood is a high priced coffee shop that serves english food. It is located near Ranch and has a customer rating of 1 out of 5.
"name[Wildwood], eatType[coffee shop], food[English], priceRange[high], customer rating[average], near[Ranch]"	Wildwood is a high priced coffee shop located near Ranch. It has an average customer rating.
"name[Wildwood], eatType[coffee shop], food[English], priceRange[less than £20], customer rating[low], near[Ranch]"	Wildwood is a low-priced coffee shop located near Ranch. It has a low customer rating.
"name[Wildwood], eatType[coffee shop], food[English], priceRange[moderate], customer rating[1 out of 5], near[Ranch]"	Wildwood is a moderately priced coffee shop with a customer rating of 1 out of 5. It is located near Ranch.
"name[Wildwood], eatType[coffee shop], food[English], priceRange[moderate], customer rating[3 out of 5], near[Ranch]"	Wildwood is a moderately priced coffee shop near Ranch. It serves english food and has a customer rating of 3 out of 5.
